device,s1,s2,s3,s4,sum,sum-squared,time-ms,state
/dev/fakeUSB0,468,471,469,462,1870,3496900,20,quiescent
/dev/fakeUSB0,476,472,474,464,1886,3556996,40,quiescent
/dev/fakeUSB0,464,464,466,465,1859,3455881,60,quiescent
/dev/fakeUSB0,467,462,455,462,1846,3407716,80,quiescent
/dev/fakeUSB0,470,466,472,464,1872,3504384,100,quiescent
/dev/fakeUSB0,466,465,463,465,1859,3455881,120,quiescent
/dev/fakeUSB0,468,476,478,472,1894,3587236,140,quiescent
/dev/fakeUSB0,468,468,466,465,1867,3485689,160,quiescent
/dev/fakeUSB0,471,471,476,463,1881,3538161,180,quiescent
/dev/fakeUSB0,464,467,464,465,1860,3459600,200,quiescent
/dev/fakeUSB0,475,475,474,476,1900,3610000,220,quiescent
/dev/fakeUSB0,468,463,465,456,1852,3429904,240,quiescent
/dev/fakeUSB0,473,480,485,473,1911,3651921,260,quiescent
/dev/fakeUSB0,460,458,449,468,1835,3367225,280,quiescent
/dev/fakeUSB0,475,471,473,468,1887,3560769,300,quiescent
/dev/fakeUSB0,461,451,455,464,1831,3352561,320,quiescent
/dev/fakeUSB0,466,477,469,463,1875,3515625,340,quiescent
/dev/fakeUSB0,462,458,455,461,1836,3370896,360,quiescent
/dev/fakeUSB0,465,479,468,462,1874,3511876,380,quiescent
/dev/fakeUSB0,468,460,463,457,1848,3415104,400,quiescent
/dev/fakeUSB0,470,469,469,465,1873,3508129,420,quiescent
/dev/fakeUSB0,472,471,468,462,1873,3508129,440,quiescent
/dev/fakeUSB0,471,471,480,468,1890,3572100,460,quiescent
/dev/fakeUSB0,470,474,468,462,1874,3511876,480,quiescent
/dev/fakeUSB0,469,473,472,468,1882,3541924,500,quiescent
/dev/fakeUSB0,468,468,467,465,1868,3489424,520,quiescent
/dev/fakeUSB0,467,471,464,460,1862,3467044,540,quiescent
/dev/fakeUSB0,463,472,468,473,1876,3519376,560,quiescent
/dev/fakeUSB0,470,468,465,455,1858,3452164,580,quiescent
/dev/fakeUSB0,460,473,468,460,1861,3463321,600,quiescent
/dev/fakeUSB0,460,457,463,460,1840,3385600,620,quiescent
/dev/fakeUSB0,467,466,481,476,1890,3572100,640,quiescent
/dev/fakeUSB0,462,458,467,468,1855,3441025,660,quiescent
/dev/fakeUSB0,468,468,489,462,1887,3560769,680,quiescent
/dev/fakeUSB0,471,455,459,469,1854,3437316,700,quiescent
/dev/fakeUSB0,468,476,481,471,1896,3594816,720,quiescent
/dev/fakeUSB0,466,457,464,464,1851,3426201,740,quiescent
/dev/fakeUSB0,471,480,473,470,1894,3587236,760,quiescent
/dev/fakeUSB0,461,459,454,464,1838,3378244,780,quiescent
/dev/fakeUSB0,470,479,472,469,1890,3572100,800,quiescent
/dev/fakeUSB0,465,454,457,460,1836,3370896,820,quiescent
/dev/fakeUSB0,466,479,472,470,1887,3560769,840,quiescent
/dev/fakeUSB0,471,456,468,455,1850,3422500,860,quiescent
/dev/fakeUSB0,467,475,482,468,1892,3579664,880,quiescent
/dev/fakeUSB0,471,459,460,467,1857,3448449,900,quiescent
/dev/fakeUSB0,464,477,476,464,1881,3538161,920,quiescent
/dev/fakeUSB0,462,469,459,464,1854,3437316,940,quiescent
/dev/fakeUSB0,469,476,463,470,1878,3526884,960,quiescent
/dev/fakeUSB0,467,467,464,464,1862,3467044,980,quiescent
/dev/fakeUSB0,471,475,461,469,1876,3519376,1000,quiescent
/dev/fakeUSB0,468,469,470,470,1877,3523129,1020,quiescent
/dev/fakeUSB0,468,465,467,472,1872,3504384,1040,quiescent
/dev/fakeUSB0,468,477,471,476,1892,3579664,1060,quiescent
/dev/fakeUSB0,469,468,463,465,1865,3478225,1080,quiescent
/dev/fakeUSB0,468,469,474,467,1878,3526884,1100,quiescent
/dev/fakeUSB0,467,457,461,463,1848,3415104,1120,quiescent
/dev/fakeUSB0,471,468,474,468,1881,3538161,1140,quiescent
/dev/fakeUSB0,463,458,462,470,1853,3433609,1160,quiescent
/dev/fakeUSB0,468,476,475,463,1882,3541924,1180,quiescent
/dev/fakeUSB0,471,467,460,467,1865,3478225,1200,quiescent
/dev/fakeUSB0,469,479,471,464,1883,3545689,1220,quiescent
/dev/fakeUSB0,467,458,464,458,1847,3411409,1240,quiescent
/dev/fakeUSB0,474,474,476,463,1887,3560769,1260,quiescent
/dev/fakeUSB0,464,453,454,459,1830,3348900,1280,quiescent
/dev/fakeUSB0,470,476,487,476,1909,3644281,1300,quiescent
/dev/fakeUSB0,465,455,459,464,1843,3396649,1320,quiescent
/dev/fakeUSB0,477,468,469,476,1890,3572100,1340,quiescent
/dev/fakeUSB0,472,463,463,471,1869,3493161,1360,quiescent
/dev/fakeUSB0,468,472,465,458,1863,3470769,1380,quiescent
/dev/fakeUSB0,469,463,460,468,1860,3459600,1400,quiescent
/dev/fakeUSB0,468,478,468,464,1878,3526884,1420,quiescent
/dev/fakeUSB0,467,468,457,460,1852,3429904,1440,quiescent
/dev/fakeUSB0,476,467,468,458,1869,3493161,1460,quiescent
/dev/fakeUSB0,471,467,466,470,1874,3511876,1480,quiescent
/dev/fakeUSB0,469,469,467,460,1865,3478225,1500,quiescent
/dev/fakeUSB0,471,472,473,462,1878,3526884,1520,quiescent
/dev/fakeUSB0,465,460,463,465,1853,3433609,1540,quiescent
/dev/fakeUSB0,456,455,473,468,1852,3429904,1560,quiescent
/dev/fakeUSB0,452,456,464,466,1838,3378244,1580,quiescent
/dev/fakeUSB0,460,459,475,471,1865,3478225,1600,quiescent
/dev/fakeUSB0,452,452,462,461,1827,3337929,1620,quiescent
/dev/fakeUSB0,461,474,476,468,1879,3530641,1640,quiescent
/dev/fakeUSB0,467,455,457,461,1840,3385600,1660,quiescent
/dev/fakeUSB0,469,470,482,474,1895,3591025,1680,quiescent
/dev/fakeUSB0,470,458,453,464,1845,3404025,1700,quiescent
/dev/fakeUSB0,470,473,479,468,1890,3572100,1720,quiescent
/dev/fakeUSB0,464,457,456,460,1837,3374569,1740,quiescent
/dev/fakeUSB0,468,475,484,468,1895,3591025,1760,quiescent
/dev/fakeUSB0,460,458,461,463,1842,3392964,1780,quiescent
/dev/fakeUSB0,466,476,476,468,1886,3556996,1800,quiescent
/dev/fakeUSB0,465,462,464,462,1853,3433609,1820,quiescent
/dev/fakeUSB0,471,473,480,472,1896,3594816,1840,quiescent
/dev/fakeUSB0,462,457,461,467,1847,3411409,1860,quiescent
/dev/fakeUSB0,465,468,470,468,1871,3500641,1880,quiescent
/dev/fakeUSB0,466,464,462,460,1852,3429904,1900,quiescent
/dev/fakeUSB0,468,468,464,463,1863,3470769,1920,quiescent
/dev/fakeUSB0,461,461,462,457,1841,3389281,1940,quiescent
/dev/fakeUSB0,460,467,463,472,1862,3467044,1960,quiescent
/dev/fakeUSB0,464,465,470,468,1867,3485689,1980,quiescent
/dev/fakeUSB0,469,460,467,464,1860,3459600,2000,quiescent
/dev/fakeUSB0,468,471,468,462,1869,3493161,2020,quiescent
/dev/fakeUSB0,471,460,468,464,1863,3470769,2040,quiescent
/dev/fakeUSB0,463,467,477,476,1883,3545689,2060,quiescent
/dev/fakeUSB0,466,462,465,460,1853,3433609,2080,quiescent
/dev/fakeUSB0,469,471,473,469,1882,3541924,2100,quiescent
/dev/fakeUSB0,463,462,455,467,1847,3411409,2120,quiescent
/dev/fakeUSB0,465,471,483,470,1889,3568321,2140,quiescent
/dev/fakeUSB0,461,459,466,458,1844,3400336,2160,quiescent
/dev/fakeUSB0,473,470,474,475,1892,3579664,2180,quiescent
/dev/fakeUSB0,465,451,462,464,1842,3392964,2200,quiescent
/dev/fakeUSB0,463,469,472,476,1880,3534400,2220,quiescent
/dev/fakeUSB0,460,458,459,459,1836,3370896,2240,quiescent
/dev/fakeUSB0,468,477,476,464,1885,3553225,2260,quiescent
/dev/fakeUSB0,463,460,462,464,1849,3418801,2280,quiescent
/dev/fakeUSB0,474,479,473,461,1887,3560769,2300,quiescent
/dev/fakeUSB0,464,462,468,462,1856,3444736,2320,quiescent
/dev/fakeUSB0,467,474,475,466,1882,3541924,2340,quiescent
/dev/fakeUSB0,461,463,461,455,1840,3385600,2360,quiescent
/dev/fakeUSB0,468,473,464,467,1872,3504384,2380,quiescent
/dev/fakeUSB0,468,465,462,468,1863,3470769,2400,quiescent
/dev/fakeUSB0,459,468,475,470,1872,3504384,2420,quiescent
/dev/fakeUSB0,467,467,469,467,1870,3496900,2440,quiescent
/dev/fakeUSB0,468,468,468,468,1872,3504384,2460,quiescent
/dev/fakeUSB0,465,471,467,467,1870,3496900,2480,quiescent
/dev/fakeUSB0,466,465,459,466,1856,3444736,2500,quiescent
/dev/fakeUSB0,466,472,477,469,1884,3549456,2520,quiescent
/dev/fakeUSB0,469,463,463,468,1863,3470769,2540,quiescent
/dev/fakeUSB0,468,476,473,464,1881,3538161,2560,quiescent
/dev/fakeUSB0,464,461,459,458,1842,3392964,2580,quiescent
/dev/fakeUSB0,470,480,469,465,1884,3549456,2600,quiescent
/dev/fakeUSB0,461,460,461,465,1847,3411409,2620,quiescent
/dev/fakeUSB0,474,476,487,477,1914,3663396,2640,quiescent
/dev/fakeUSB0,465,456,466,466,1853,3433609,2660,quiescent
/dev/fakeUSB0,472,473,484,471,1900,3610000,2680,quiescent
/dev/fakeUSB0,460,463,469,463,1855,3441025,2700,quiescent
/dev/fakeUSB0,470,479,483,476,1908,3640464,2720,quiescent
/dev/fakeUSB0,469,460,453,467,1849,3418801,2740,quiescent
/dev/fakeUSB0,473,471,479,467,1890,3572100,2760,quiescent
/dev/fakeUSB0,467,456,463,459,1845,3404025,2780,quiescent
/dev/fakeUSB0,474,473,471,465,1883,3545689,2800,quiescent
/dev/fakeUSB0,460,464,454,461,1839,3381921,2820,quiescent
/dev/fakeUSB0,468,475,475,469,1887,3560769,2840,quiescent
/dev/fakeUSB0,458,464,445,468,1835,3367225,2860,quiescent
/dev/fakeUSB0,464,467,476,474,1881,3538161,2880,quiescent
/dev/fakeUSB0,464,464,460,468,1856,3444736,2900,quiescent
/dev/fakeUSB0,473,468,466,459,1866,3481956,2920,quiescent
/dev/fakeUSB0,468,472,471,464,1875,3515625,2940,quiescent
/dev/fakeUSB0,472,468,455,461,1856,3444736,2960,quiescent
/dev/fakeUSB0,468,468,471,471,1878,3526884,2980,quiescent
/dev/fakeUSB0,464,460,461,469,1854,3437316,3000,quiescent
/dev/fakeUSB0,474,469,470,464,1877,3523129,3020,quiescent
/dev/fakeUSB0,469,462,464,465,1860,3459600,3040,quiescent
/dev/fakeUSB0,475,476,472,469,1892,3579664,3060,quiescent
/dev/fakeUSB0,473,459,460,460,1852,3429904,3080,quiescent
/dev/fakeUSB0,470,477,477,471,1895,3591025,3100,quiescent
/dev/fakeUSB0,462,455,463,460,1840,3385600,3120,quiescent
/dev/fakeUSB0,464,481,479,468,1892,3579664,3140,quiescent
/dev/fakeUSB0,461,461,457,463,1842,3392964,3160,quiescent
/dev/fakeUSB0,461,476,477,475,1889,3568321,3180,quiescent
/dev/fakeUSB0,458,458,455,466,1837,3374569,3200,quiescent
/dev/fakeUSB0,475,469,476,469,1889,3568321,3220,quiescent
/dev/fakeUSB0,471,463,459,467,1860,3459600,3240,quiescent
/dev/fakeUSB0,469,476,473,465,1883,3545689,3260,quiescent
/dev/fakeUSB0,467,463,469,460,1859,3455881,3280,quiescent
/dev/fakeUSB0,472,476,481,467,1896,3594816,3300,quiescent
/dev/fakeUSB0,459,468,464,468,1859,3455881,3320,quiescent
/dev/fakeUSB0,461,477,475,460,1873,3508129,3340,quiescent
/dev/fakeUSB0,463,464,469,462,1858,3452164,3360,quiescent
/dev/fakeUSB0,468,471,471,458,1868,3489424,3380,quiescent
/dev/fakeUSB0,467,468,465,458,1858,3452164,3400,quiescent
/dev/fakeUSB0,466,465,468,469,1868,3489424,3420,quiescent
/dev/fakeUSB0,474,465,470,464,1873,3508129,3440,quiescent
/dev/fakeUSB0,470,460,468,467,1865,3478225,3460,quiescent
/dev/fakeUSB0,466,467,476,468,1877,3523129,3480,quiescent
/dev/fakeUSB0,465,458,467,471,1861,3463321,3500,quiescent
/dev/fakeUSB0,468,470,480,469,1887,3560769,3520,quiescent
/dev/fakeUSB0,464,459,460,470,1853,3433609,3540,quiescent
/dev/fakeUSB0,469,475,470,468,1882,3541924,3560,quiescent
/dev/fakeUSB0,465,458,451,468,1842,3392964,3580,quiescent
/dev/fakeUSB0,468,481,478,468,1895,3591025,3600,quiescent
/dev/fakeUSB0,468,456,458,460,1842,3392964,3620,quiescent
/dev/fakeUSB0,468,475,476,472,1891,3575881,3640,quiescent
/dev/fakeUSB0,460,463,460,463,1846,3407716,3660,quiescent
/dev/fakeUSB0,469,481,484,477,1911,3651921,3680,quiescent
/dev/fakeUSB0,467,463,456,467,1853,3433609,3700,quiescent
/dev/fakeUSB0,471,476,476,479,1902,3617604,3720,quiescent
/dev/fakeUSB0,465,460,460,459,1844,3400336,3740,quiescent
/dev/fakeUSB0,469,478,470,468,1885,3553225,3760,quiescent
/dev/fakeUSB0,466,461,461,461,1849,3418801,3780,quiescent
/dev/fakeUSB0,464,471,468,464,1867,3485689,3800,quiescent
/dev/fakeUSB0,460,470,464,460,1854,3437316,3820,quiescent
/dev/fakeUSB0,476,476,470,468,1890,3572100,3840,quiescent
/dev/fakeUSB0,468,464,465,467,1864,3474496,3860,quiescent
/dev/fakeUSB0,471,471,464,461,1867,3485689,3880,quiescent
/dev/fakeUSB0,464,468,466,469,1867,3485689,3900,quiescent
/dev/fakeUSB0,467,463,471,468,1869,3493161,3920,quiescent
/dev/fakeUSB0,468,463,472,476,1879,3530641,3940,quiescent
/dev/fakeUSB0,463,464,466,466,1859,3455881,3960,quiescent
/dev/fakeUSB0,471,468,479,467,1885,3553225,3980,quiescent
/dev/fakeUSB0,472,464,457,466,1859,3455881,4000,quiescent
/dev/fakeUSB0,465,473,479,464,1881,3538161,4020,quiescent
/dev/fakeUSB0,465,456,466,464,1851,3426201,4040,quiescent
/dev/fakeUSB0,466,481,480,464,1891,3575881,4060,quiescent
/dev/fakeUSB0,462,459,456,463,1840,3385600,4080,quiescent
/dev/fakeUSB0,467,476,476,461,1880,3534400,4100,quiescent
/dev/fakeUSB0,462,456,453,460,1831,3352561,4120,quiescent
/dev/fakeUSB0,467,468,488,470,1893,3583449,4140,quiescent
/dev/fakeUSB0,459,454,457,457,1827,3337929,4160,quiescent
/dev/fakeUSB0,468,476,472,473,1889,3568321,4180,quiescent
/dev/fakeUSB0,463,459,461,465,1848,3415104,4200,quiescent
/dev/fakeUSB0,468,473,476,469,1886,3556996,4220,quiescent
/dev/fakeUSB0,463,465,459,464,1851,3426201,4240,quiescent
/dev/fakeUSB0,468,468,476,465,1877,3523129,4260,quiescent
/dev/fakeUSB0,462,465,468,465,1860,3459600,4280,quiescent
/dev/fakeUSB0,467,468,468,464,1867,3485689,4300,quiescent
/dev/fakeUSB0,467,461,460,462,1850,3422500,4320,quiescent
/dev/fakeUSB0,468,463,466,469,1866,3481956,4340,quiescent
/dev/fakeUSB0,467,465,465,464,1861,3463321,4360,quiescent
/dev/fakeUSB0,469,471,476,472,1888,3564544,4380,quiescent
/dev/fakeUSB0,471,472,476,468,1887,3560769,4400,quiescent
/dev/fakeUSB0,465,468,476,464,1873,3508129,4420,quiescent
/dev/fakeUSB0,468,464,473,472,1877,3523129,4440,quiescent
/dev/fakeUSB0,460,460,461,468,1849,3418801,4460,quiescent
/dev/fakeUSB0,462,470,477,474,1883,3545689,4480,quiescent
/dev/fakeUSB0,469,470,463,468,1870,3496900,4500,quiescent
/dev/fakeUSB0,463,472,487,472,1894,3587236,4520,quiescent
/dev/fakeUSB0,463,460,468,464,1855,3441025,4540,quiescent
/dev/fakeUSB0,463,475,485,473,1896,3594816,4560,quiescent
/dev/fakeUSB0,467,460,473,468,1868,3489424,4580,quiescent
/dev/fakeUSB0,472,484,487,468,1911,3651921,4600,quiescent
/dev/fakeUSB0,466,466,461,462,1855,3441025,4620,quiescent
/dev/fakeUSB0,474,476,492,468,1910,3648100,4640,quiescent
/dev/fakeUSB0,466,466,465,456,1853,3433609,4660,quiescent
/dev/fakeUSB0,468,480,481,460,1889,3568321,4680,quiescent
/dev/fakeUSB0,464,459,462,459,1844,3400336,4700,quiescent
/dev/fakeUSB0,469,480,480,460,1889,3568321,4720,quiescent
/dev/fakeUSB0,467,469,464,457,1857,3448449,4740,quiescent
/dev/fakeUSB0,467,476,473,460,1876,3519376,4760,quiescent
/dev/fakeUSB0,462,467,472,456,1857,3448449,4780,quiescent
/dev/fakeUSB0,474,465,478,469,1886,3556996,4800,quiescent
/dev/fakeUSB0,461,466,460,463,1850,3422500,4820,quiescent
/dev/fakeUSB0,472,464,464,471,1871,3500641,4840,quiescent
/dev/fakeUSB0,470,463,472,472,1877,3523129,4860,quiescent
/dev/fakeUSB0,463,467,476,470,1876,3519376,4880,quiescent
/dev/fakeUSB0,463,470,476,466,1875,3515625,4900,quiescent
/dev/fakeUSB0,466,463,460,460,1849,3418801,4920,quiescent
/dev/fakeUSB0,468,472,468,463,1871,3500641,4940,quiescent
/dev/fakeUSB0,467,461,457,454,1839,3381921,4960,quiescent
/dev/fakeUSB0,474,471,479,469,1893,3583449,4980,quiescent
/dev/fakeUSB0,460,458,456,459,1833,3359889,5000,quiescent
/dev/fakeUSB0,468,474,475,465,1882,3541924,5020,quiescent
/dev/fakeUSB0,468,460,459,465,1852,3429904,5040,quiescent
/dev/fakeUSB0,467,478,474,473,1892,3579664,5060,quiescent
/dev/fakeUSB0,468,460,446,466,1840,3385600,5080,quiescent
/dev/fakeUSB0,473,472,477,473,1895,3591025,5100,quiescent
/dev/fakeUSB0,463,455,460,465,1843,3396649,5120,quiescent
/dev/fakeUSB0,472,475,478,472,1897,3598609,5140,quiescent
/dev/fakeUSB0,464,464,458,455,1841,3389281,5160,quiescent
/dev/fakeUSB0,474,481,475,465,1895,3591025,5180,quiescent
/dev/fakeUSB0,464,460,460,465,1849,3418801,5200,quiescent
/dev/fakeUSB0,471,479,478,465,1893,3583449,5220,quiescent
/dev/fakeUSB0,469,463,466,462,1860,3459600,5240,quiescent
/dev/fakeUSB0,468,474,471,472,1885,3553225,5260,quiescent
/dev/fakeUSB0,467,466,467,463,1863,3470769,5280,quiescent
/dev/fakeUSB0,465,471,468,473,1877,3523129,5300,quiescent
/dev/fakeUSB0,471,465,460,466,1862,3467044,5320,quiescent
/dev/fakeUSB0,466,467,464,468,1865,3478225,5340,quiescent
/dev/fakeUSB0,464,468,455,462,1849,3418801,5360,quiescent
/dev/fakeUSB0,464,470,458,452,1844,3400336,5380,quiescent
/dev/fakeUSB0,469,475,470,464,1878,3526884,5400,quiescent
/dev/fakeUSB0,466,460,465,459,1850,3422500,5420,quiescent
/dev/fakeUSB0,463,464,476,469,1872,3504384,5440,quiescent
/dev/fakeUSB0,471,453,459,470,1853,3433609,5460,quiescent
/dev/fakeUSB0,465,473,474,480,1892,3579664,5480,quiescent
/dev/fakeUSB0,470,455,455,464,1844,3400336,5500,quiescent
/dev/fakeUSB0,471,472,481,466,1890,3572100,5520,quiescent
/dev/fakeUSB0,461,464,466,458,1849,3418801,5540,quiescent
/dev/fakeUSB0,476,476,479,463,1894,3587236,5560,quiescent
/dev/fakeUSB0,461,460,466,458,1845,3404025,5580,quiescent
/dev/fakeUSB0,472,475,473,462,1882,3541924,5600,quiescent
/dev/fakeUSB0,466,462,463,468,1859,3455881,5620,quiescent
/dev/fakeUSB0,474,480,471,473,1898,3602404,5640,quiescent
/dev/fakeUSB0,464,464,457,461,1846,3407716,5660,quiescent
/dev/fakeUSB0,464,477,479,473,1893,3583449,5680,quiescent
/dev/fakeUSB0,465,464,456,461,1846,3407716,5700,quiescent
/dev/fakeUSB0,470,478,473,467,1888,3564544,5720,quiescent
/dev/fakeUSB0,461,459,466,462,1848,3415104,5740,quiescent
/dev/fakeUSB0,467,467,475,469,1878,3526884,5760,quiescent
/dev/fakeUSB0,468,467,464,468,1867,3485689,5780,quiescent
/dev/fakeUSB0,469,474,475,469,1887,3560769,5800,quiescent
/dev/fakeUSB0,461,464,467,465,1857,3448449,5820,quiescent
/dev/fakeUSB0,466,466,464,467,1863,3470769,5840,quiescent
/dev/fakeUSB0,464,458,473,469,1864,3474496,5860,quiescent
/dev/fakeUSB0,461,456,461,458,1836,3370896,5880,quiescent
/dev/fakeUSB0,463,464,470,468,1865,3478225,5900,quiescent
/dev/fakeUSB0,460,460,460,463,1843,3396649,5920,quiescent
/dev/fakeUSB0,466,476,481,467,1890,3572100,5940,quiescent
/dev/fakeUSB0,467,468,460,463,1858,3452164,5960,quiescent
/dev/fakeUSB0,474,482,475,465,1896,3594816,5980,quiescent
/dev/fakeUSB0,467,462,451,463,1843,3396649,6000,quiescent
/dev/fakeUSB0,465,471,476,473,1885,3553225,6020,quiescent
/dev/fakeUSB0,464,459,449,468,1840,3385600,6040,quiescent
/dev/fakeUSB0,469,476,478,473,1896,3594816,6060,quiescent
/dev/fakeUSB0,460,462,451,457,1830,3348900,6080,quiescent
/dev/fakeUSB0,473,479,476,474,1902,3617604,6100,quiescent
/dev/fakeUSB0,464,450,463,465,1842,3392964,6120,quiescent
/dev/fakeUSB0,468,476,483,470,1897,3598609,6140,quiescent
/dev/fakeUSB0,467,468,468,468,1871,3500641,6160,quiescent
/dev/fakeUSB0,468,484,482,470,1904,3625216,6180,quiescent
/dev/fakeUSB0,463,477,477,460,1877,3523129,6200,quiescent
/dev/fakeUSB0,472,487,481,465,1905,3629025,6220,quiescent
/dev/fakeUSB0,476,483,464,472,1895,3591025,6240,quiescent
/dev/fakeUSB0,476,494,471,469,1910,3648100,6260,quiescent
/dev/fakeUSB0,481,490,470,470,1911,3651921,6280,quiescent
/dev/fakeUSB0,478,484,472,468,1902,3617604,6300,quiescent
/dev/fakeUSB0,478,489,474,467,1908,3640464,6320,quiescent
/dev/fakeUSB0,482,483,476,465,1906,3632836,6340,quiescent
/dev/fakeUSB0,476,475,476,464,1891,3575881,6360,quiescent
/dev/fakeUSB0,475,460,467,459,1861,3463321,6380,quiescent
/dev/fakeUSB0,475,468,486,466,1895,3591025,6400,quiescent
/dev/fakeUSB0,467,458,468,456,1849,3418801,6420,quiescent
/dev/fakeUSB0,467,464,475,465,1871,3500641,6440,quiescent
/dev/fakeUSB0,476,447,453,459,1835,3367225,6460,quiescent
/dev/fakeUSB0,481,460,475,472,1888,3564544,6480,quiescent
/dev/fakeUSB0,470,439,467,465,1841,3389281,6500,quiescent
/dev/fakeUSB0,479,468,480,475,1902,3617604,6520,quiescent
/dev/fakeUSB0,478,455,466,461,1860,3459600,6540,quiescent
/dev/fakeUSB0,476,488,493,473,1930,3724900,6560,quiescent
/dev/fakeUSB0,476,481,462,464,1883,3545689,6580,quiescent
/dev/fakeUSB0,473,510,480,472,1935,3744225,6600,quiescent
/dev/fakeUSB0,468,515,468,464,1915,3667225,6620,quiescent
/dev/fakeUSB0,469,538,486,468,1961,3845521,6640,quiescent
/dev/fakeUSB0,465,532,477,455,1929,3721041,6660,quiescent
/dev/fakeUSB0,475,543,484,468,1970,3880900,6680,pickup
/dev/fakeUSB0,478,539,477,456,1950,3802500,6700,pickup
/dev/fakeUSB0,478,540,483,468,1969,3876961,6720,pickup
/dev/fakeUSB0,476,532,494,465,1967,3869089,6740,pickup
/dev/fakeUSB0,479,521,501,471,1972,3888784,6760,pickup
/dev/fakeUSB0,487,517,514,464,1982,3928324,6780,pickup
/dev/fakeUSB0,493,561,527,468,2049,4198401,6800,pickup
/dev/fakeUSB0,489,843,537,475,2344,5494336,6820,pickup
/dev/fakeUSB0,499,1012,570,467,2548,6492304,6840,pickup
/dev/fakeUSB0,500,999,653,470,2622,6874884,6860,pickup
/dev/fakeUSB0,506,1023,815,461,2805,7868025,6880,pickup
/dev/fakeUSB0,510,1023,1021,465,3019,9114361,6900,pickup
/dev/fakeUSB0,510,1013,1015,477,3015,9090225,6920,pickup
/dev/fakeUSB0,519,1003,998,483,3003,9018009,6940,pickup
/dev/fakeUSB0,528,1019,1023,500,3070,9424900,6960,pickup
/dev/fakeUSB0,541,1012,1003,519,3075,9455625,6980,pickup
/dev/fakeUSB0,754,717,1007,530,3008,9048064,7000,pickup
/dev/fakeUSB0,1021,560,1007,557,3145,9891025,7020,pickup
/dev/fakeUSB0,1023,456,1023,543,3045,9272025,7040,pickup
/dev/fakeUSB0,1019,445,1023,544,3031,9186961,7060,pickup
/dev/fakeUSB0,1023,436,1022,509,2990,8940100,7080,pickup
/dev/fakeUSB0,1017,468,1023,498,3006,9036036,7100,pickup
/dev/fakeUSB0,1015,476,1021,476,2988,8928144,7120,pickup
/dev/fakeUSB0,1023,504,1017,466,3010,9060100,7140,pickup
/dev/fakeUSB0,1016,500,1023,441,2980,8880400,7160,pickup
/dev/fakeUSB0,967,519,447,443,2376,5645376,7180,pickup
/dev/fakeUSB0,782,516,151,429,1878,3526884,7200,pickup
/dev/fakeUSB0,696,521,76,425,1718,2951524,7220,pickup
/dev/fakeUSB0,660,510,146,424,1740,3027600,7240,pickup
/dev/fakeUSB0,668,516,252,444,1880,3534400,7260,pickup
/dev/fakeUSB0,687,515,325,460,1987,3948169,7280,pickup
/dev/fakeUSB0,620,511,293,474,1898,3602404,7300,pickup
/dev/fakeUSB0,527,502,208,468,1705,2907025,7320,pickup
/dev/fakeUSB0,460,496,136,446,1538,2365444,7340,pickup
/dev/fakeUSB0,431,500,120,447,1498,2244004,7360,pickup
/dev/fakeUSB0,426,498,157,438,1519,2307361,7380,pickup
/dev/fakeUSB0,405,519,252,450,1626,2643876,7400,pickup
/dev/fakeUSB0,377,511,331,457,1676,2808976,7420,pickup
/dev/fakeUSB0,383,537,412,463,1795,3222025,7440,pickup
/dev/fakeUSB0,421,530,426,465,1842,3392964,7460,pickup
/dev/fakeUSB0,456,553,460,480,1949,3798601,7480,pickup
/dev/fakeUSB0,391,537,429,461,1818,3305124,7500,pickup
/dev/fakeUSB0,230,543,428,460,1661,2758921,7520,pickup
/dev/fakeUSB0,113,517,414,435,1479,2187441,7540,pickup
/dev/fakeUSB0,80,520,432,428,1460,2131600,7560,pickup
/dev/fakeUSB0,10,493,427,379,1309,1713481,7580,pickup
/dev/fakeUSB0,0,489,456,312,1257,1580049,7600,pickup
/dev/fakeUSB0,0,477,460,262,1199,1437601,7620,pickup
/dev/fakeUSB0,0,480,469,288,1237,1530169,7640,pickup
/dev/fakeUSB0,0,469,448,329,1246,1552516,7660,pickup
/dev/fakeUSB0,0,482,440,380,1302,1695204,7680,pickup
/dev/fakeUSB0,66,478,409,417,1370,1876900,7700,pickup
/dev/fakeUSB0,356,490,400,439,1685,2839225,7720,pickup
/dev/fakeUSB0,495,482,402,435,1814,3290596,7740,pickup
/dev/fakeUSB0,593,491,405,406,1895,3591025,7760,pickup
/dev/fakeUSB0,825,489,400,358,2072,4293184,7780,pickup
/dev/fakeUSB0,1021,499,397,312,2229,4968441,7800,pickup
/dev/fakeUSB0,1021,507,395,325,2248,5053504,7820,pickup
/dev/fakeUSB0,1023,477,356,338,2194,4813636,7840,pickup
/dev/fakeUSB0,1023,399,324,357,2103,4422609,7860,pickup
/dev/fakeUSB0,1023,296,267,359,1945,3783025,7880,pickup
/dev/fakeUSB0,1023,232,249,393,1897,3598609,7900,pickup
/dev/fakeUSB0,1023,208,235,460,1926,3709476,7920,pickup
/dev/fakeUSB0,1013,232,260,539,2044,4177936,7940,pickup
/dev/fakeUSB0,1009,234,277,591,2111,4456321,7960,pickup
/dev/fakeUSB0,1023,224,325,613,2185,4774225,7980,pickup
/dev/fakeUSB0,1003,170,329,595,2097,4397409,8000,pickup
/dev/fakeUSB0,935,152,339,581,2007,4028049,8020,pickup
/dev/fakeUSB0,607,136,324,572,1639,2686321,8040,pickup
/dev/fakeUSB0,437,199,344,585,1565,2449225,8060,pickup
/dev/fakeUSB0,359,270,323,583,1535,2356225,8080,pickup
/dev/fakeUSB0,364,383,320,592,1659,2752281,8100,pickup
/dev/fakeUSB0,403,467,298,583,1751,3066001,8120,pickup
/dev/fakeUSB0,460,561,304,597,1922,3694084,8140,pickup
/dev/fakeUSB0,500,609,326,590,2025,4100625,8160,pickup
/dev/fakeUSB0,527,639,432,581,2179,4748041,8180,pickup
/dev/fakeUSB0,513,628,680,544,2365,5593225,8200,pickup
/dev/fakeUSB0,497,605,1004,493,2599,6754801,8220,pickup
/dev/fakeUSB0,484,592,1023,427,2526,6380676,8240,pickup
/dev/fakeUSB0,467,618,1014,366,2465,6076225,8260,pickup
/dev/fakeUSB0,452,687,1023,343,2505,6275025,8280,pickup
/dev/fakeUSB0,436,764,1023,348,2571,6610041,8300,pickup
/dev/fakeUSB0,428,827,1023,371,2649,7017201,8320,pickup
/dev/fakeUSB0,408,813,1023,390,2634,6937956,8340,pickup
/dev/fakeUSB0,404,767,1023,383,2577,6640929,8360,pickup
/dev/fakeUSB0,381,777,1023,352,2533,6416089,8380,pickup
/dev/fakeUSB0,351,895,1011,320,2577,6640929,8400,pickup
/dev/fakeUSB0,277,981,85,288,1631,2660161,8420,pickup
/dev/fakeUSB0,208,818,0,334,1360,1849600,8440,pickup
/dev/fakeUSB0,168,532,0,484,1184,1401856,8460,pickup
/dev/fakeUSB0,160,280,0,689,1129,1274641,8480,pickup
/dev/fakeUSB0,132,201,0,910,1243,1545049,8500,pickup
/dev/fakeUSB0,135,332,0,1009,1476,2178576,8520,pickup
/dev/fakeUSB0,169,533,0,1021,1723,2968729,8540,pickup
/dev/fakeUSB0,245,684,0,1023,1952,3810304,8560,pickup
/dev/fakeUSB0,309,687,0,950,1946,3786916,8580,pickup
/dev/fakeUSB0,364,626,0,731,1721,2961841,8600,pickup
/dev/fakeUSB0,370,571,0,555,1496,2238016,8620,pickup
/dev/fakeUSB0,375,578,0,412,1365,1863225,8640,pickup
/dev/fakeUSB0,366,646,0,306,1318,1737124,8660,pickup
/dev/fakeUSB0,382,747,0,260,1389,1929321,8680,pickup
/dev/fakeUSB0,391,783,0,237,1411,1990921,8700,pickup
/dev/fakeUSB0,412,719,0,257,1388,1926544,8720,pickup
/dev/fakeUSB0,405,658,0,254,1317,1734489,8740,pickup
/dev/fakeUSB0,416,681,0,176,1273,1620529,8760,pickup
/dev/fakeUSB0,441,814,0,69,1324,1752976,8780,pickup
/dev/fakeUSB0,472,935,0,0,1407,1979649,8800,pickup
/dev/fakeUSB0,486,873,0,0,1359,1846881,8820,pickup
/dev/fakeUSB0,468,715,0,0,1183,1399489,8840,pickup
/dev/fakeUSB0,443,609,0,0,1052,1106704,8860,pickup
/dev/fakeUSB0,380,506,0,0,886,784996,8880,pickup
/dev/fakeUSB0,267,461,0,0,728,529984,8900,pickup
/dev/fakeUSB0,29,447,0,0,476,226576,8920,pickup
/dev/fakeUSB0,0,442,0,0,442,195364,8940,pickup
/dev/fakeUSB0,0,423,0,0,423,178929,8960,pickup
/dev/fakeUSB0,0,364,0,0,364,132496,8980,pickup
/dev/fakeUSB0,0,203,0,0,203,41209,9000,pickup
/dev/fakeUSB0,0,10,0,0,10,100,9020,pickup
/dev/fakeUSB0,0,0,0,0,0,0,9040,pickup
/dev/fakeUSB0,0,0,0,0,0,0,9060,pickup
/dev/fakeUSB0,0,0,0,0,0,0,9080,pickup
/dev/fakeUSB0,0,0,0,0,0,0,9100,pickup
/dev/fakeUSB0,0,0,0,0,0,0,9120,pickup
/dev/fakeUSB0,0,0,0,0,0,0,9140,pickup
/dev/fakeUSB0,0,0,0,0,0,0,9160,pickup
/dev/fakeUSB0,0,0,0,0,0,0,9180,pickup
/dev/fakeUSB0,0,349,676,0,1025,1050625,9200,pickup
/dev/fakeUSB0,0,1011,1023,0,2034,4137156,9220,pickup
/dev/fakeUSB0,0,997,1023,0,2020,4080400,9240,pickup
/dev/fakeUSB0,0,1004,1023,0,2027,4108729,9260,pickup
/dev/fakeUSB0,0,469,1023,0,1492,2226064,9280,pickup
/dev/fakeUSB0,0,0,1017,0,1017,1034289,9300,pickup
/dev/fakeUSB0,0,0,244,0,244,59536,9320,pickup
/dev/fakeUSB0,0,0,0,0,0,0,9340,pickup
/dev/fakeUSB0,0,0,0,0,0,0,9360,pickup
/dev/fakeUSB0,0,0,0,0,0,0,9380,pickup
/dev/fakeUSB0,0,0,0,0,0,0,9400,pickup
/dev/fakeUSB0,0,0,0,0,0,0,9420,pickup
/dev/fakeUSB0,0,0,0,0,0,0,9440,pickup
/dev/fakeUSB0,0,0,0,0,0,0,9460,pickup
/dev/fakeUSB0,0,0,0,0,0,0,9480,pickup
/dev/fakeUSB0,0,0,0,0,0,0,9500,pickup
/dev/fakeUSB0,0,0,0,0,0,0,9520,pickup
/dev/fakeUSB0,0,0,0,0,0,0,9540,pickup
/dev/fakeUSB0,0,0,0,0,0,0,9560,pickup
/dev/fakeUSB0,0,0,0,0,0,0,9580,pickup
/dev/fakeUSB0,0,0,0,0,0,0,9600,pickup
/dev/fakeUSB0,0,0,0,0,0,0,9620,pickup
/dev/fakeUSB0,0,0,0,0,0,0,9640,pickup
/dev/fakeUSB0,0,0,0,0,0,0,9660,pickup
/dev/fakeUSB0,0,0,0,0,0,0,9680,pickup
/dev/fakeUSB0,0,0,0,0,0,0,9700,pickup
/dev/fakeUSB0,0,0,0,0,0,0,9720,pickup
/dev/fakeUSB0,0,0,0,0,0,0,9740,pickup
/dev/fakeUSB0,0,0,0,0,0,0,9760,pickup
/dev/fakeUSB0,0,0,0,0,0,0,9780,pickup
/dev/fakeUSB0,0,0,0,0,0,0,9800,pickup
/dev/fakeUSB0,0,0,0,0,0,0,9820,pickup
/dev/fakeUSB0,0,0,0,0,0,0,9840,pickup
/dev/fakeUSB0,0,0,0,0,0,0,9860,pickup
/dev/fakeUSB0,0,0,0,0,0,0,9880,pickup
/dev/fakeUSB0,0,0,0,0,0,0,9900,pickup
/dev/fakeUSB0,0,0,0,0,0,0,9920,pickup
/dev/fakeUSB0,0,0,0,0,0,0,9940,pickup
/dev/fakeUSB0,0,0,0,0,0,0,9960,pickup
/dev/fakeUSB0,0,0,0,0,0,0,9980,pickup
/dev/fakeUSB0,0,0,0,0,0,0,10000,pickup
/dev/fakeUSB0,0,0,0,0,0,0,10020,pickup
/dev/fakeUSB0,0,0,0,0,0,0,10040,pickup
/dev/fakeUSB0,0,0,0,0,0,0,10060,pickup
/dev/fakeUSB0,0,0,0,0,0,0,10080,pickup
/dev/fakeUSB0,0,0,0,0,0,0,10100,pickup
/dev/fakeUSB0,0,0,0,0,0,0,10120,pickup
/dev/fakeUSB0,0,0,0,0,0,0,10140,pickup
/dev/fakeUSB0,0,0,0,0,0,0,10160,pickup
/dev/fakeUSB0,0,0,0,0,0,0,10180,pickup
/dev/fakeUSB0,0,0,0,0,0,0,10200,pickup
/dev/fakeUSB0,0,0,0,0,0,0,10220,pickup
/dev/fakeUSB0,0,0,0,0,0,0,10240,pickup
/dev/fakeUSB0,0,0,0,0,0,0,10260,pickup
/dev/fakeUSB0,0,0,0,0,0,0,10280,pickup
/dev/fakeUSB0,0,0,0,0,0,0,10300,pickup
/dev/fakeUSB0,0,0,0,0,0,0,10320,pickup
/dev/fakeUSB0,0,0,0,0,0,0,10340,pickup
/dev/fakeUSB0,0,0,0,0,0,0,10360,pickup
/dev/fakeUSB0,0,0,0,0,0,0,10380,pickup
/dev/fakeUSB0,0,0,0,0,0,0,10400,pickup
/dev/fakeUSB0,0,0,0,0,0,0,10420,pickup
/dev/fakeUSB0,0,0,0,0,0,0,10440,pickup
/dev/fakeUSB0,0,0,0,0,0,0,10460,pickup
/dev/fakeUSB0,0,0,0,0,0,0,10480,pickup
/dev/fakeUSB0,0,0,0,0,0,0,10500,pickup
/dev/fakeUSB0,0,0,0,0,0,0,10520,pickup
/dev/fakeUSB0,0,0,0,0,0,0,10540,pickup
/dev/fakeUSB0,0,0,0,0,0,0,10560,pickup
/dev/fakeUSB0,0,0,0,0,0,0,10580,pickup
/dev/fakeUSB0,0,0,0,0,0,0,10600,pickup
/dev/fakeUSB0,0,0,0,0,0,0,10620,pickup
/dev/fakeUSB0,0,0,0,0,0,0,10640,pickup
/dev/fakeUSB0,0,0,0,0,0,0,10660,pickup
/dev/fakeUSB0,0,0,0,0,0,0,10680,pickup
/dev/fakeUSB0,0,0,0,0,0,0,10700,pickup
/dev/fakeUSB0,0,0,0,0,0,0,10720,pickup
/dev/fakeUSB0,0,0,0,0,0,0,10740,pickup
/dev/fakeUSB0,0,0,0,0,0,0,10760,pickup
/dev/fakeUSB0,0,0,0,0,0,0,10780,pickup
/dev/fakeUSB0,0,0,0,0,0,0,10800,pickup
/dev/fakeUSB0,0,0,0,0,0,0,10820,pickup
/dev/fakeUSB0,0,0,0,0,0,0,10840,pickup
/dev/fakeUSB0,0,0,0,0,0,0,10860,pickup
/dev/fakeUSB0,0,0,0,0,0,0,10880,pickup
/dev/fakeUSB0,0,0,0,0,0,0,10900,pickup
/dev/fakeUSB0,0,0,0,0,0,0,10920,pickup
/dev/fakeUSB0,0,0,0,0,0,0,10940,pickup
/dev/fakeUSB0,0,0,0,0,0,0,10960,pickup
/dev/fakeUSB0,0,0,0,0,0,0,10980,pickup
/dev/fakeUSB0,0,0,0,0,0,0,11000,pickup
/dev/fakeUSB0,0,0,0,0,0,0,11020,pickup
/dev/fakeUSB0,0,0,0,0,0,0,11040,pickup
/dev/fakeUSB0,0,0,0,0,0,0,11060,pickup
/dev/fakeUSB0,0,0,0,0,0,0,11080,pickup
/dev/fakeUSB0,0,0,0,0,0,0,11100,pickup
/dev/fakeUSB0,0,0,0,0,0,0,11120,pickup
/dev/fakeUSB0,0,0,0,0,0,0,11140,pickup
/dev/fakeUSB0,0,0,0,0,0,0,11160,pickup
/dev/fakeUSB0,0,0,0,0,0,0,11180,pickup
/dev/fakeUSB0,0,0,0,0,0,0,11200,pickup
/dev/fakeUSB0,0,0,0,0,0,0,11220,pickup
/dev/fakeUSB0,0,0,0,0,0,0,11240,pickup
/dev/fakeUSB0,0,0,0,0,0,0,11260,pickup
/dev/fakeUSB0,0,0,0,0,0,0,11280,pickup
/dev/fakeUSB0,0,0,0,0,0,0,11300,pickup
/dev/fakeUSB0,0,0,0,0,0,0,11320,pickup
/dev/fakeUSB0,0,0,0,0,0,0,11340,pickup
/dev/fakeUSB0,28,0,0,0,28,784,11360,pickup
/dev/fakeUSB0,158,0,0,0,158,24964,11380,pickup
/dev/fakeUSB0,235,0,0,0,235,55225,11400,pickup
/dev/fakeUSB0,246,0,0,0,246,60516,11420,pickup
/dev/fakeUSB0,228,0,0,0,228,51984,11440,pickup
/dev/fakeUSB0,209,0,0,0,209,43681,11460,pickup
/dev/fakeUSB0,217,0,0,0,217,47089,11480,pickup
/dev/fakeUSB0,198,0,0,0,198,39204,11500,pickup
/dev/fakeUSB0,200,0,0,0,200,40000,11520,pickup
/dev/fakeUSB0,224,0,0,0,224,50176,11540,pickup
/dev/fakeUSB0,236,0,0,0,236,55696,11560,pickup
/dev/fakeUSB0,259,0,0,0,259,67081,11580,pickup
/dev/fakeUSB0,259,0,0,0,259,67081,11600,pickup
/dev/fakeUSB0,284,0,0,0,284,80656,11620,pickup
/dev/fakeUSB0,291,0,0,0,291,84681,11640,pickup
/dev/fakeUSB0,284,0,0,0,284,80656,11660,pickup
/dev/fakeUSB0,307,0,0,0,307,94249,11680,pickup
/dev/fakeUSB0,309,0,0,0,309,95481,11700,pickup
/dev/fakeUSB0,316,0,0,0,316,99856,11720,pickup
/dev/fakeUSB0,323,0,0,0,323,104329,11740,pickup
/dev/fakeUSB0,309,0,0,0,309,95481,11760,pickup
/dev/fakeUSB0,316,0,0,0,316,99856,11780,pickup
/dev/fakeUSB0,319,0,0,0,319,101761,11800,pickup
/dev/fakeUSB0,310,0,0,0,310,96100,11820,pickup
/dev/fakeUSB0,321,0,0,0,321,103041,11840,pickup
/dev/fakeUSB0,324,0,0,0,324,104976,11860,pickup
/dev/fakeUSB0,322,0,0,0,322,103684,11880,pickup
/dev/fakeUSB0,324,0,0,0,324,104976,11900,pickup
/dev/fakeUSB0,336,0,0,0,336,112896,11920,pickup
/dev/fakeUSB0,349,0,0,0,349,121801,11940,pickup
/dev/fakeUSB0,340,0,0,0,340,115600,11960,pickup
/dev/fakeUSB0,344,0,0,0,344,118336,11980,pickup
/dev/fakeUSB0,348,0,0,0,348,121104,12000,pickup
/dev/fakeUSB0,347,0,0,0,347,120409,12020,pickup
/dev/fakeUSB0,343,0,0,0,343,117649,12040,pickup
/dev/fakeUSB0,336,0,0,0,336,112896,12060,pickup
/dev/fakeUSB0,340,0,0,0,340,115600,12080,pickup
/dev/fakeUSB0,332,0,0,0,332,110224,12100,pickup
/dev/fakeUSB0,330,0,0,0,330,108900,12120,pickup
/dev/fakeUSB0,331,0,0,0,331,109561,12140,pickup
/dev/fakeUSB0,348,0,0,0,348,121104,12160,pickup
/dev/fakeUSB0,369,0,0,0,369,136161,12180,pickup
/dev/fakeUSB0,376,0,0,0,376,141376,12200,pickup
/dev/fakeUSB0,381,0,0,0,381,145161,12220,pickup
/dev/fakeUSB0,396,0,0,0,396,156816,12240,pickup
/dev/fakeUSB0,398,0,0,0,398,158404,12260,pickup
/dev/fakeUSB0,405,0,0,0,405,164025,12280,pickup
/dev/fakeUSB0,407,0,0,0,407,165649,12300,pickup
/dev/fakeUSB0,428,0,0,0,428,183184,12320,pickup
/dev/fakeUSB0,440,0,0,0,440,193600,12340,pickup
/dev/fakeUSB0,446,0,0,0,446,198916,12360,pickup
/dev/fakeUSB0,469,0,0,164,633,400689,12380,pickup
/dev/fakeUSB0,460,0,0,391,851,724201,12400,pickup
/dev/fakeUSB0,457,0,0,515,972,944784,12420,pickup
/dev/fakeUSB0,452,0,0,587,1039,1079521,12440,pickup
/dev/fakeUSB0,453,0,0,594,1047,1096209,12460,pickup
/dev/fakeUSB0,456,0,0,548,1004,1008016,12480,pickup
/dev/fakeUSB0,452,0,0,511,963,927369,12500,pickup
/dev/fakeUSB0,447,0,0,485,932,868624,12520,pickup
/dev/fakeUSB0,461,0,0,457,918,842724,12540,pickup
/dev/fakeUSB0,445,0,142,436,1023,1046529,12560,pickup
/dev/fakeUSB0,444,0,339,432,1215,1476225,12580,pickup
/dev/fakeUSB0,435,0,443,425,1303,1697809,12600,pickup
/dev/fakeUSB0,444,0,493,428,1365,1863225,12620,pickup
/dev/fakeUSB0,451,0,497,428,1376,1893376,12640,pickup
/dev/fakeUSB0,446,0,469,432,1347,1814409,12660,pickup
/dev/fakeUSB0,450,0,447,439,1336,1784896,12680,pickup
/dev/fakeUSB0,452,0,405,434,1291,1666681,12700,pickup
/dev/fakeUSB0,428,0,395,431,1254,1572516,12720,pickup
/dev/fakeUSB0,431,0,396,418,1245,1550025,12740,pickup
/dev/fakeUSB0,419,0,398,432,1249,1560001,12760,pickup
/dev/fakeUSB0,423,0,383,429,1235,1525225,12780,pickup
/dev/fakeUSB0,437,0,398,433,1268,1607824,12800,pickup
/dev/fakeUSB0,459,0,409,434,1302,1695204,12820,pickup
/dev/fakeUSB0,482,0,412,439,1333,1776889,12840,pickup
/dev/fakeUSB0,481,0,413,452,1346,1811716,12860,pickup
/dev/fakeUSB0,476,0,412,447,1335,1782225,12880,pickup
/dev/fakeUSB0,458,0,412,451,1321,1745041,12900,pickup
/dev/fakeUSB0,446,0,420,461,1327,1760929,12920,pickup
/dev/fakeUSB0,436,0,412,444,1292,1669264,12940,pickup
/dev/fakeUSB0,422,0,407,435,1264,1597696,12960,pickup
/dev/fakeUSB0,421,0,421,441,1283,1646089,12980,pickup
/dev/fakeUSB0,439,0,428,439,1306,1705636,13000,pickup
/dev/fakeUSB0,443,0,425,448,1316,1731856,13020,pickup
/dev/fakeUSB0,450,0,426,450,1326,1758276,13040,pickup
/dev/fakeUSB0,452,0,432,462,1346,1811716,13060,pickup
/dev/fakeUSB0,451,0,430,477,1358,1844164,13080,pickup
/dev/fakeUSB0,443,0,428,470,1341,1798281,13100,pickup
/dev/fakeUSB0,427,0,418,458,1303,1697809,13120,pickup
/dev/fakeUSB0,430,0,429,456,1315,1729225,13140,pickup
/dev/fakeUSB0,430,0,425,457,1312,1721344,13160,pickup
/dev/fakeUSB0,437,0,422,445,1304,1700416,13180,pickup
/dev/fakeUSB0,432,0,438,461,1331,1771561,13200,pickup
/dev/fakeUSB0,434,0,434,457,1325,1755625,13220,pickup
/dev/fakeUSB0,436,0,423,462,1321,1745041,13240,pickup
/dev/fakeUSB0,439,0,423,451,1313,1723969,13260,pickup
/dev/fakeUSB0,442,0,437,460,1339,1792921,13280,pickup
/dev/fakeUSB0,457,0,435,459,1351,1825201,13300,pickup
/dev/fakeUSB0,444,0,426,458,1328,1763584,13320,pickup
/dev/fakeUSB0,444,0,430,459,1333,1776889,13340,pickup
/dev/fakeUSB0,431,0,422,456,1309,1713481,13360,pickup
/dev/fakeUSB0,428,0,445,453,1326,1758276,13380,pickup
/dev/fakeUSB0,425,0,445,453,1323,1750329,13400,pickup
/dev/fakeUSB0,418,0,445,467,1330,1768900,13420,pickup
/dev/fakeUSB0,429,0,448,464,1341,1798281,13440,pickup
/dev/fakeUSB0,428,0,433,462,1323,1750329,13460,pickup
/dev/fakeUSB0,423,0,449,470,1342,1800964,13480,pickup
/dev/fakeUSB0,411,0,425,452,1288,1658944,13500,pickup
/dev/fakeUSB0,411,0,441,445,1297,1682209,13520,pickup
/dev/fakeUSB0,408,0,436,449,1293,1671849,13540,pickup
/dev/fakeUSB0,406,0,435,439,1280,1638400,13560,pickup
/dev/fakeUSB0,396,0,431,434,1261,1590121,13580,pickup
/dev/fakeUSB0,383,0,428,447,1258,1582564,13600,pickup
/dev/fakeUSB0,391,0,433,452,1276,1628176,13620,pickup
/dev/fakeUSB0,406,0,432,448,1286,1653796,13640,pickup
/dev/fakeUSB0,398,0,433,445,1276,1628176,13660,pickup
/dev/fakeUSB0,415,0,443,448,1306,1705636,13680,pickup
/dev/fakeUSB0,412,0,433,447,1292,1669264,13700,pickup
/dev/fakeUSB0,429,0,436,453,1318,1737124,13720,pickup
/dev/fakeUSB0,436,0,453,477,1366,1865956,13740,pickup
/dev/fakeUSB0,447,80,454,490,1471,2163841,13760,pickup
/dev/fakeUSB0,462,292,436,500,1690,2856100,13780,pickup
/dev/fakeUSB0,444,418,432,500,1794,3218436,13800,pickup
/dev/fakeUSB0,445,482,442,524,1893,3583449,13820,pickup
/dev/fakeUSB0,447,486,448,508,1889,3568321,13840,pickup
/dev/fakeUSB0,449,469,441,516,1875,3515625,13860,pickup
/dev/fakeUSB0,438,450,444,507,1839,3381921,13880,pickup
/dev/fakeUSB0,426,430,449,505,1810,3276100,13900,pickup
/dev/fakeUSB0,443,415,442,492,1792,3211264,13920,pickup
/dev/fakeUSB0,434,401,444,492,1771,3136441,13940,pickup
/dev/fakeUSB0,424,407,440,481,1752,3069504,13960,pickup
/dev/fakeUSB0,435,413,442,475,1765,3115225,13980,pickup
/dev/fakeUSB0,434,417,434,480,1765,3115225,14000,pickup
/dev/fakeUSB0,447,404,429,476,1756,3083536,14020,pickup
/dev/fakeUSB0,437,413,428,477,1755,3080025,14040,pickup
/dev/fakeUSB0,435,417,428,472,1752,3069504,14060,pickup
/dev/fakeUSB0,433,407,436,476,1752,3069504,14080,pickup
/dev/fakeUSB0,440,415,439,485,1779,3164841,14100,pickup
/dev/fakeUSB0,427,430,436,490,1783,3179089,14120,pickup
/dev/fakeUSB0,444,424,438,485,1791,3207681,14140,pickup
/dev/fakeUSB0,451,419,434,476,1780,3168400,14160,pickup
/dev/fakeUSB0,444,416,433,467,1760,3097600,14180,pickup
/dev/fakeUSB0,450,412,443,471,1776,3154176,14200,pickup
/dev/fakeUSB0,432,429,437,480,1778,3161284,14220,pickup
/dev/fakeUSB0,450,416,445,477,1788,3196944,14240,pickup
/dev/fakeUSB0,444,416,453,491,1804,3254416,14260,pickup
/dev/fakeUSB0,439,406,448,484,1777,3157729,14280,pickup
/dev/fakeUSB0,436,413,421,484,1754,3076516,14300,pickup
/dev/fakeUSB0,436,416,429,476,1757,3087049,14320,pickup
/dev/fakeUSB0,416,420,436,488,1760,3097600,14340,pickup
/dev/fakeUSB0,428,411,447,474,1760,3097600,14360,pickup
/dev/fakeUSB0,432,429,439,502,1802,3247204,14380,pickup
/dev/fakeUSB0,456,441,424,471,1792,3211264,14400,pickup
/dev/fakeUSB0,460,434,443,471,1808,3268864,14420,pickup
/dev/fakeUSB0,493,439,444,514,1890,3572100,14440,heartbeat
/dev/fakeUSB0,525,457,436,508,1926,3709476,14460,heartbeat
/dev/fakeUSB0,531,449,467,537,1984,3936256,14480,heartbeat
/dev/fakeUSB0,507,456,464,535,1962,3849444,14500,heartbeat
/dev/fakeUSB0,508,462,452,533,1955,3822025,14520,heartbeat
/dev/fakeUSB0,485,463,447,516,1911,3651921,14540,heartbeat
/dev/fakeUSB0,465,457,444,510,1876,3519376,14560,heartbeat
/dev/fakeUSB0,460,444,426,491,1821,3316041,14580,heartbeat
/dev/fakeUSB0,457,439,452,491,1839,3381921,14600,heartbeat
/dev/fakeUSB0,459,433,435,496,1823,3323329,14620,heartbeat
/dev/fakeUSB0,467,433,436,478,1814,3290596,14640,heartbeat
/dev/fakeUSB0,471,433,438,480,1822,3319684,14660,heartbeat
/dev/fakeUSB0,489,439,451,470,1849,3418801,14680,heartbeat
/dev/fakeUSB0,500,448,460,500,1908,3640464,14700,heartbeat
/dev/fakeUSB0,498,439,448,488,1873,3508129,14720,heartbeat
/dev/fakeUSB0,494,441,460,485,1880,3534400,14740,heartbeat
/dev/fakeUSB0,472,443,459,489,1863,3470769,14760,heartbeat
/dev/fakeUSB0,468,456,445,499,1868,3489424,14780,heartbeat
/dev/fakeUSB0,449,450,447,499,1845,3404025,14800,heartbeat
/dev/fakeUSB0,450,455,437,493,1835,3367225,14820,heartbeat
/dev/fakeUSB0,448,443,449,497,1837,3374569,14840,heartbeat
/dev/fakeUSB0,443,449,433,488,1813,3286969,14860,heartbeat
/dev/fakeUSB0,431,435,445,481,1792,3211264,14880,heartbeat
/dev/fakeUSB0,431,447,436,478,1792,3211264,14900,heartbeat
/dev/fakeUSB0,452,433,451,474,1810,3276100,14920,heartbeat
/dev/fakeUSB0,449,436,458,461,1804,3254416,14940,heartbeat
/dev/fakeUSB0,454,436,439,474,1803,3250809,14960,heartbeat
/dev/fakeUSB0,452,440,447,459,1798,3232804,14980,heartbeat
/dev/fakeUSB0,470,433,448,464,1815,3294225,15000,heartbeat
/dev/fakeUSB0,472,433,451,464,1820,3312400,15020,heartbeat
/dev/fakeUSB0,461,428,444,469,1802,3247204,15040,heartbeat
/dev/fakeUSB0,456,444,454,468,1822,3319684,15060,heartbeat
/dev/fakeUSB0,471,447,445,467,1830,3348900,15080,heartbeat
/dev/fakeUSB0,492,442,460,473,1867,3485689,15100,heartbeat
/dev/fakeUSB0,497,463,461,476,1897,3598609,15120,heartbeat
/dev/fakeUSB0,530,463,466,508,1967,3869089,15140,heartbeat
/dev/fakeUSB0,551,477,458,505,1991,3964081,15160,heartbeat
/dev/fakeUSB0,556,479,471,518,2024,4096576,15180,heartbeat
/dev/fakeUSB0,556,489,452,515,2012,4048144,15200,heartbeat
/dev/fakeUSB0,551,479,454,499,1983,3932289,15220,heartbeat
/dev/fakeUSB0,523,475,452,503,1953,3814209,15240,heartbeat
/dev/fakeUSB0,511,473,449,480,1913,3659569,15260,heartbeat
/dev/fakeUSB0,500,459,456,463,1878,3526884,15280,heartbeat
/dev/fakeUSB0,491,458,443,456,1848,3415104,15300,heartbeat
/dev/fakeUSB0,484,465,448,463,1860,3459600,15320,heartbeat
/dev/fakeUSB0,481,454,454,452,1841,3389281,15340,heartbeat
/dev/fakeUSB0,468,452,440,461,1821,3316041,15360,heartbeat
/dev/fakeUSB0,474,446,455,467,1842,3392964,15380,heartbeat
/dev/fakeUSB0,490,455,443,468,1856,3444736,15400,heartbeat
/dev/fakeUSB0,483,460,462,462,1867,3485689,15420,heartbeat
/dev/fakeUSB0,477,455,468,468,1868,3489424,15440,heartbeat
/dev/fakeUSB0,482,468,458,468,1876,3519376,15460,heartbeat
/dev/fakeUSB0,476,460,467,463,1866,3481956,15480,heartbeat
/dev/fakeUSB0,462,461,464,460,1847,3411409,15500,heartbeat
/dev/fakeUSB0,447,443,456,453,1799,3236401,15520,heartbeat
/dev/fakeUSB0,464,444,458,476,1842,3392964,15540,heartbeat
/dev/fakeUSB0,460,438,464,452,1814,3290596,15560,heartbeat
/dev/fakeUSB0,450,438,450,448,1786,3189796,15580,heartbeat
/dev/fakeUSB0,434,452,444,460,1790,3204100,15600,heartbeat
/dev/fakeUSB0,452,442,444,459,1797,3229209,15620,heartbeat
/dev/fakeUSB0,436,441,447,445,1769,3129361,15640,heartbeat
/dev/fakeUSB0,428,445,459,444,1776,3154176,15660,heartbeat
/dev/fakeUSB0,439,432,449,447,1767,3122289,15680,heartbeat
/dev/fakeUSB0,446,438,457,436,1777,3157729,15700,heartbeat
/dev/fakeUSB0,445,440,460,447,1792,3211264,15720,heartbeat
/dev/fakeUSB0,441,452,457,433,1783,3179089,15740,heartbeat
/dev/fakeUSB0,453,442,460,452,1807,3265249,15760,heartbeat
/dev/fakeUSB0,462,452,455,453,1822,3319684,15780,heartbeat
/dev/fakeUSB0,479,460,453,457,1849,3418801,15800,heartbeat
/dev/fakeUSB0,511,468,469,475,1923,3697929,15820,heartbeat
/dev/fakeUSB0,522,484,471,504,1981,3924361,15840,heartbeat
/dev/fakeUSB0,531,499,477,503,2010,4040100,15860,heartbeat
/dev/fakeUSB0,540,497,478,499,2014,4056196,15880,heartbeat
/dev/fakeUSB0,516,492,463,465,1936,3748096,15900,heartbeat
/dev/fakeUSB0,500,490,460,458,1908,3640464,15920,heartbeat
/dev/fakeUSB0,505,479,472,452,1908,3640464,15940,heartbeat
/dev/fakeUSB0,490,448,473,460,1871,3500641,15960,heartbeat
/dev/fakeUSB0,466,449,464,452,1831,3352561,15980,heartbeat
/dev/fakeUSB0,458,453,451,436,1798,3232804,16000,heartbeat
/dev/fakeUSB0,459,453,458,440,1810,3276100,16020,heartbeat
/dev/fakeUSB0,449,452,452,447,1800,3240000,16040,heartbeat
/dev/fakeUSB0,457,465,445,441,1808,3268864,16060,heartbeat
/dev/fakeUSB0,460,460,458,463,1841,3389281,16080,heartbeat
/dev/fakeUSB0,467,452,471,450,1840,3385600,16100,heartbeat
/dev/fakeUSB0,468,447,468,452,1835,3367225,16120,heartbeat
/dev/fakeUSB0,466,451,453,444,1814,3290596,16140,heartbeat
/dev/fakeUSB0,478,440,471,449,1838,3378244,16160,heartbeat
/dev/fakeUSB0,456,458,455,435,1804,3254416,16180,heartbeat
/dev/fakeUSB0,466,449,449,434,1798,3232804,16200,heartbeat
/dev/fakeUSB0,452,452,459,444,1807,3265249,16220,heartbeat
/dev/fakeUSB0,444,450,449,438,1781,3171961,16240,heartbeat
/dev/fakeUSB0,445,447,444,440,1776,3154176,16260,heartbeat
/dev/fakeUSB0,419,435,456,430,1740,3027600,16280,heartbeat
/dev/fakeUSB0,436,452,467,436,1791,3207681,16300,heartbeat
/dev/fakeUSB0,436,450,463,444,1793,3214849,16320,heartbeat
/dev/fakeUSB0,425,430,453,427,1735,3010225,16340,heartbeat
/dev/fakeUSB0,418,446,444,424,1732,2999824,16360,heartbeat
/dev/fakeUSB0,428,442,459,436,1765,3115225,16380,heartbeat
/dev/fakeUSB0,428,436,446,444,1754,3076516,16400,heartbeat
/dev/fakeUSB0,422,446,445,440,1753,3073009,16420,heartbeat
/dev/fakeUSB0,414,437,445,432,1728,2985984,16440,heartbeat
/dev/fakeUSB0,432,444,442,450,1768,3125824,16460,heartbeat
/dev/fakeUSB0,452,449,457,450,1808,3268864,16480,heartbeat
/dev/fakeUSB0,472,459,473,449,1853,3433609,16500,heartbeat
/dev/fakeUSB0,486,466,474,470,1896,3594816,16520,heartbeat
/dev/fakeUSB0,500,483,478,458,1919,3682561,16540,heartbeat
/dev/fakeUSB0,506,487,460,470,1923,3697929,16560,heartbeat
/dev/fakeUSB0,487,469,480,459,1895,3591025,16580,heartbeat
/dev/fakeUSB0,487,471,466,465,1889,3568321,16600,heartbeat
/dev/fakeUSB0,477,469,460,462,1868,3489424,16620,heartbeat
/dev/fakeUSB0,467,454,468,450,1839,3381921,16640,heartbeat
/dev/fakeUSB0,448,446,459,440,1793,3214849,16660,heartbeat
/dev/fakeUSB0,445,451,464,429,1789,3200521,16680,heartbeat
/dev/fakeUSB0,438,428,463,430,1759,3094081,16700,heartbeat
/dev/fakeUSB0,436,428,455,440,1759,3094081,16720,heartbeat
/dev/fakeUSB0,423,440,468,441,1772,3139984,16740,heartbeat
/dev/fakeUSB0,433,440,454,448,1775,3150625,16760,heartbeat
/dev/fakeUSB0,437,485,444,452,1818,3305124,16780,heartbeat
/dev/fakeUSB0,442,432,462,436,1772,3139984,16800,heartbeat
/dev/fakeUSB0,433,444,455,431,1763,3108169,16820,heartbeat
/dev/fakeUSB0,428,456,459,444,1787,3193369,16840,heartbeat
/dev/fakeUSB0,431,451,463,437,1782,3175524,16860,heartbeat
/dev/fakeUSB0,425,436,454,434,1749,3059001,16880,heartbeat
/dev/fakeUSB0,420,436,452,440,1748,3055504,16900,heartbeat
/dev/fakeUSB0,408,436,462,440,1746,3048516,16920,heartbeat
/dev/fakeUSB0,414,448,446,436,1744,3041536,16940,heartbeat
/dev/fakeUSB0,395,437,453,416,1701,2893401,16960,heartbeat
/dev/fakeUSB0,414,436,454,423,1727,2982529,16980,heartbeat
/dev/fakeUSB0,406,441,455,431,1733,3003289,17000,heartbeat
/dev/fakeUSB0,408,440,443,435,1726,2979076,17020,heartbeat
/dev/fakeUSB0,411,433,450,429,1723,2968729,17040,heartbeat
/dev/fakeUSB0,420,428,461,428,1737,3017169,17060,heartbeat
/dev/fakeUSB0,420,429,443,442,1734,3006756,17080,heartbeat
/dev/fakeUSB0,414,424,452,441,1731,2996361,17100,heartbeat
/dev/fakeUSB0,422,435,437,427,1721,2961841,17120,heartbeat
/dev/fakeUSB0,414,426,440,443,1723,2968729,17140,heartbeat
/dev/fakeUSB0,411,443,448,440,1742,3034564,17160,heartbeat
/dev/fakeUSB0,430,448,462,437,1777,3157729,17180,heartbeat
/dev/fakeUSB0,426,446,466,448,1786,3189796,17200,heartbeat
/dev/fakeUSB0,452,456,453,440,1801,3243601,17220,heartbeat
/dev/fakeUSB0,460,467,465,455,1847,3411409,17240,heartbeat
/dev/fakeUSB0,460,457,455,455,1827,3337929,17260,heartbeat
/dev/fakeUSB0,448,461,462,460,1831,3352561,17280,heartbeat
/dev/fakeUSB0,447,456,464,443,1810,3276100,17300,heartbeat
/dev/fakeUSB0,448,455,451,439,1793,3214849,17320,heartbeat
/dev/fakeUSB0,433,438,443,420,1734,3006756,17340,heartbeat
/dev/fakeUSB0,427,430,457,425,1739,3024121,17360,heartbeat
/dev/fakeUSB0,439,444,464,423,1770,3132900,17380,heartbeat
/dev/fakeUSB0,420,436,455,440,1751,3066001,17400,heartbeat
/dev/fakeUSB0,413,440,440,444,1737,3017169,17420,heartbeat
/dev/fakeUSB0,416,444,461,436,1757,3087049,17440,heartbeat
/dev/fakeUSB0,429,442,463,441,1775,3150625,17460,heartbeat
/dev/fakeUSB0,423,451,449,449,1772,3139984,17480,heartbeat
/dev/fakeUSB0,430,436,445,435,1746,3048516,17500,heartbeat
/dev/fakeUSB0,432,429,456,456,1773,3143529,17520,heartbeat
/dev/fakeUSB0,442,435,457,451,1785,3186225,17540,heartbeat
/dev/fakeUSB0,436,435,448,443,1762,3104644,17560,heartbeat
/dev/fakeUSB0,420,434,458,444,1756,3083536,17580,heartbeat
/dev/fakeUSB0,416,436,464,449,1765,3115225,17600,heartbeat
/dev/fakeUSB0,425,436,449,452,1762,3104644,17620,heartbeat
/dev/fakeUSB0,425,436,448,431,1740,3027600,17640,heartbeat
/dev/fakeUSB0,423,435,433,424,1715,2941225,17660,heartbeat
/dev/fakeUSB0,416,439,463,439,1757,3087049,17680,heartbeat
/dev/fakeUSB0,438,434,445,435,1752,3069504,17700,heartbeat
/dev/fakeUSB0,429,432,457,440,1758,3090564,17720,heartbeat
/dev/fakeUSB0,434,433,452,446,1765,3115225,17740,heartbeat
/dev/fakeUSB0,424,431,449,449,1753,3073009,17760,heartbeat
/dev/fakeUSB0,436,445,445,449,1775,3150625,17780,heartbeat
/dev/fakeUSB0,427,447,445,443,1762,3104644,17800,heartbeat
/dev/fakeUSB0,430,437,436,446,1749,3059001,17820,heartbeat
/dev/fakeUSB0,440,444,454,444,1782,3175524,17840,heartbeat
/dev/fakeUSB0,440,430,456,446,1772,3139984,17860,heartbeat
/dev/fakeUSB0,467,442,455,440,1804,3254416,17880,heartbeat
/dev/fakeUSB0,465,452,453,451,1821,3316041,17900,heartbeat
/dev/fakeUSB0,482,456,461,475,1874,3511876,17920,heartbeat
/dev/fakeUSB0,483,456,473,452,1864,3474496,17940,heartbeat
/dev/fakeUSB0,479,449,452,449,1829,3345241,17960,heartbeat
/dev/fakeUSB0,464,456,451,452,1823,3323329,17980,heartbeat
/dev/fakeUSB0,454,447,460,444,1805,3258025,18000,heartbeat
/dev/fakeUSB0,456,444,451,438,1789,3200521,18020,heartbeat
/dev/fakeUSB0,463,438,451,447,1799,3236401,18040,heartbeat
/dev/fakeUSB0,452,429,464,438,1783,3179089,18060,heartbeat
/dev/fakeUSB0,456,429,470,436,1791,3207681,18080,heartbeat
/dev/fakeUSB0,446,437,452,441,1776,3154176,18100,heartbeat
/dev/fakeUSB0,444,457,442,431,1774,3147076,18120,heartbeat
/dev/fakeUSB0,457,436,447,453,1793,3214849,18140,heartbeat
/dev/fakeUSB0,452,441,461,460,1814,3290596,18160,heartbeat
/dev/fakeUSB0,452,444,446,444,1786,3189796,18180,heartbeat
/dev/fakeUSB0,452,438,467,445,1802,3247204,18200,heartbeat
/dev/fakeUSB0,455,440,460,432,1787,3193369,18220,heartbeat
/dev/fakeUSB0,452,446,463,445,1806,3261636,18240,heartbeat
/dev/fakeUSB0,450,444,438,444,1776,3154176,18260,heartbeat
/dev/fakeUSB0,446,447,453,442,1788,3196944,18280,heartbeat
/dev/fakeUSB0,449,453,454,439,1795,3222025,18300,heartbeat
/dev/fakeUSB0,448,443,464,449,1804,3254416,18320,heartbeat
/dev/fakeUSB0,451,439,442,438,1770,3132900,18340,heartbeat
/dev/fakeUSB0,435,432,449,438,1754,3076516,18360,heartbeat
/dev/fakeUSB0,456,437,468,437,1798,3232804,18380,heartbeat
/dev/fakeUSB0,443,452,461,446,1802,3247204,18400,heartbeat
/dev/fakeUSB0,439,447,444,452,1782,3175524,18420,heartbeat
/dev/fakeUSB0,434,443,446,450,1773,3143529,18440,heartbeat
/dev/fakeUSB0,439,437,462,436,1774,3147076,18460,heartbeat
/dev/fakeUSB0,439,436,444,429,1748,3055504,18480,heartbeat
/dev/fakeUSB0,436,430,450,442,1758,3090564,18500,heartbeat
/dev/fakeUSB0,442,436,440,436,1754,3076516,18520,heartbeat
/dev/fakeUSB0,446,437,455,442,1780,3168400,18540,heartbeat
/dev/fakeUSB0,448,436,453,431,1768,3125824,18560,heartbeat
/dev/fakeUSB0,476,449,473,461,1859,3455881,18580,heartbeat
/dev/fakeUSB0,478,452,459,477,1866,3481956,18600,heartbeat
/dev/fakeUSB0,514,461,469,472,1916,3671056,18620,heartbeat
/dev/fakeUSB0,500,459,469,471,1899,3606201,18640,heartbeat
/dev/fakeUSB0,488,459,476,455,1878,3526884,18660,heartbeat
/dev/fakeUSB0,489,455,468,457,1869,3493161,18680,heartbeat
/dev/fakeUSB0,480,460,450,451,1841,3389281,18700,heartbeat
/dev/fakeUSB0,454,446,475,457,1832,3356224,18720,heartbeat
/dev/fakeUSB0,440,437,444,459,1780,3168400,18740,heartbeat
/dev/fakeUSB0,453,444,462,444,1803,3250809,18760,heartbeat
/dev/fakeUSB0,437,444,455,435,1771,3136441,18780,heartbeat
/dev/fakeUSB0,445,451,446,444,1786,3189796,18800,heartbeat
/dev/fakeUSB0,459,447,453,455,1814,3290596,18820,heartbeat
/dev/fakeUSB0,451,445,449,448,1793,3214849,18840,heartbeat
/dev/fakeUSB0,467,452,457,436,1812,3283344,18860,heartbeat
/dev/fakeUSB0,459,446,445,447,1797,3229209,18880,heartbeat
/dev/fakeUSB0,459,449,453,445,1806,3261636,18900,heartbeat
/dev/fakeUSB0,457,455,467,449,1828,3341584,18920,heartbeat
/dev/fakeUSB0,453,458,451,457,1819,3308761,18940,heartbeat
/dev/fakeUSB0,459,439,462,444,1804,3254416,18960,heartbeat
/dev/fakeUSB0,448,449,453,438,1788,3196944,18980,heartbeat
/dev/fakeUSB0,454,448,449,452,1803,3250809,19000,heartbeat
/dev/fakeUSB0,450,448,445,447,1790,3204100,19020,heartbeat
/dev/fakeUSB0,442,456,456,443,1797,3229209,19040,heartbeat
/dev/fakeUSB0,448,452,444,444,1788,3196944,19060,heartbeat
/dev/fakeUSB0,448,436,448,445,1777,3157729,19080,heartbeat
/dev/fakeUSB0,436,439,447,452,1774,3147076,19100,heartbeat
/dev/fakeUSB0,432,441,457,436,1766,3118756,19120,heartbeat
/dev/fakeUSB0,433,441,459,441,1774,3147076,19140,heartbeat
/dev/fakeUSB0,436,443,456,435,1770,3132900,19160,heartbeat
/dev/fakeUSB0,448,447,428,428,1751,3066001,19180,heartbeat
/dev/fakeUSB0,432,448,451,447,1778,3161284,19200,heartbeat
/dev/fakeUSB0,442,448,448,439,1777,3157729,19220,heartbeat
/dev/fakeUSB0,452,458,461,442,1813,3286969,19240,heartbeat
/dev/fakeUSB0,458,457,457,447,1819,3308761,19260,heartbeat
/dev/fakeUSB0,479,471,468,464,1882,3541924,19280,heartbeat
/dev/fakeUSB0,486,468,462,459,1875,3515625,19300,heartbeat
/dev/fakeUSB0,502,476,455,472,1905,3629025,19320,heartbeat
/dev/fakeUSB0,493,464,480,484,1921,3690241,19340,heartbeat
/dev/fakeUSB0,480,460,470,467,1877,3523129,19360,heartbeat
/dev/fakeUSB0,490,465,474,462,1891,3575881,19380,heartbeat
/dev/fakeUSB0,473,458,444,457,1832,3356224,19400,heartbeat
/dev/fakeUSB0,461,453,454,452,1820,3312400,19420,heartbeat
/dev/fakeUSB0,463,466,457,456,1842,3392964,19440,heartbeat
/dev/fakeUSB0,457,444,460,465,1826,3334276,19460,heartbeat
/dev/fakeUSB0,460,458,459,455,1832,3356224,19480,heartbeat
/dev/fakeUSB0,444,460,451,442,1797,3229209,19500,heartbeat
/dev/fakeUSB0,445,452,444,442,1783,3179089,19520,heartbeat
/dev/fakeUSB0,445,461,470,458,1834,3363556,19540,heartbeat
/dev/fakeUSB0,449,450,449,460,1808,3268864,19560,heartbeat
/dev/fakeUSB0,450,458,441,450,1799,3236401,19580,heartbeat
/dev/fakeUSB0,449,468,460,453,1830,3348900,19600,heartbeat
/dev/fakeUSB0,456,460,457,456,1829,3345241,19620,heartbeat
/dev/fakeUSB0,457,448,459,451,1815,3294225,19640,heartbeat
/dev/fakeUSB0,428,456,449,451,1784,3182656,19660,heartbeat
/dev/fakeUSB0,447,445,463,465,1820,3312400,19680,heartbeat
/dev/fakeUSB0,444,449,462,460,1815,3294225,19700,heartbeat
/dev/fakeUSB0,434,445,452,465,1796,3225616,19720,heartbeat
/dev/fakeUSB0,441,441,447,453,1782,3175524,19740,heartbeat
/dev/fakeUSB0,428,441,453,453,1775,3150625,19760,heartbeat
/dev/fakeUSB0,448,448,448,446,1790,3204100,19780,heartbeat
/dev/fakeUSB0,429,442,460,451,1782,3175524,19800,heartbeat
/dev/fakeUSB0,416,460,460,438,1774,3147076,19820,heartbeat
/dev/fakeUSB0,423,457,457,447,1784,3182656,19840,heartbeat
/dev/fakeUSB0,426,460,462,446,1794,3218436,19860,heartbeat
/dev/fakeUSB0,420,446,441,441,1748,3055504,19880,heartbeat
/dev/fakeUSB0,419,441,458,447,1765,3115225,19900,heartbeat
/dev/fakeUSB0,424,441,444,438,1747,3052009,19920,heartbeat
/dev/fakeUSB0,433,440,461,448,1782,3175524,19940,heartbeat
/dev/fakeUSB0,447,448,448,469,1812,3283344,19960,heartbeat
/dev/fakeUSB0,458,467,459,478,1862,3467044,19980,heartbeat
/dev/fakeUSB0,495,462,467,497,1921,3690241,20000,heartbeat
/dev/fakeUSB0,484,481,462,489,1916,3671056,20020,heartbeat
/dev/fakeUSB0,495,484,458,497,1934,3740356,20040,heartbeat
/dev/fakeUSB0,497,497,479,501,1974,3896676,20060,heartbeat
/dev/fakeUSB0,490,485,479,504,1958,3833764,20080,heartbeat
/dev/fakeUSB0,488,484,469,490,1931,3728761,20100,heartbeat
/dev/fakeUSB0,458,487,450,472,1867,3485689,20120,heartbeat
/dev/fakeUSB0,450,474,453,474,1851,3426201,20140,heartbeat
/dev/fakeUSB0,435,467,472,471,1845,3404025,20160,heartbeat
/dev/fakeUSB0,430,461,464,476,1831,3352561,20180,heartbeat
/dev/fakeUSB0,436,463,468,464,1831,3352561,20200,heartbeat
/dev/fakeUSB0,443,469,465,463,1840,3385600,20220,heartbeat
/dev/fakeUSB0,448,469,451,460,1828,3341584,20240,heartbeat
/dev/fakeUSB0,455,477,460,467,1859,3455881,20260,heartbeat
/dev/fakeUSB0,453,465,470,468,1856,3444736,20280,heartbeat
/dev/fakeUSB0,467,466,461,484,1878,3526884,20300,heartbeat
/dev/fakeUSB0,462,460,444,460,1826,3334276,20320,heartbeat
/dev/fakeUSB0,442,453,454,470,1819,3308761,20340,heartbeat
/dev/fakeUSB0,438,460,458,472,1828,3341584,20360,heartbeat
/dev/fakeUSB0,432,462,454,469,1817,3301489,20380,heartbeat
/dev/fakeUSB0,422,455,447,468,1792,3211264,20400,heartbeat
/dev/fakeUSB0,409,452,472,462,1795,3222025,20420,heartbeat
/dev/fakeUSB0,425,456,460,456,1797,3229209,20440,heartbeat
/dev/fakeUSB0,434,452,468,454,1808,3268864,20460,heartbeat
/dev/fakeUSB0,426,462,463,460,1811,3279721,20480,heartbeat
/dev/fakeUSB0,420,459,463,452,1794,3218436,20500,heartbeat
/dev/fakeUSB0,427,447,463,452,1789,3200521,20520,heartbeat
/dev/fakeUSB0,432,463,459,447,1801,3243601,20540,heartbeat
/dev/fakeUSB0,422,455,447,462,1786,3189796,20560,heartbeat
/dev/fakeUSB0,425,448,459,457,1789,3200521,20580,heartbeat
/dev/fakeUSB0,423,460,469,461,1813,3286969,20600,heartbeat
/dev/fakeUSB0,429,460,456,468,1813,3286969,20620,heartbeat
/dev/fakeUSB0,432,443,448,461,1784,3182656,20640,heartbeat
/dev/fakeUSB0,438,456,468,465,1827,3337929,20660,heartbeat
/dev/fakeUSB0,449,479,463,477,1868,3489424,20680,heartbeat
/dev/fakeUSB0,485,478,468,507,1938,3755844,20700,heartbeat
/dev/fakeUSB0,505,496,457,508,1966,3865156,20720,heartbeat
/dev/fakeUSB0,499,509,468,527,2003,4012009,20740,heartbeat
/dev/fakeUSB0,506,515,467,510,1998,3992004,20760,heartbeat
/dev/fakeUSB0,498,503,468,507,1976,3904576,20780,heartbeat
/dev/fakeUSB0,491,484,468,487,1930,3724900,20800,heartbeat
/dev/fakeUSB0,476,484,474,500,1934,3740356,20820,heartbeat
/dev/fakeUSB0,460,475,468,491,1894,3587236,20840,heartbeat
/dev/fakeUSB0,452,479,464,472,1867,3485689,20860,heartbeat
/dev/fakeUSB0,453,473,468,456,1850,3422500,20880,heartbeat
/dev/fakeUSB0,468,464,468,463,1863,3470769,20900,heartbeat
/dev/fakeUSB0,450,462,471,479,1862,3467044,20920,heartbeat
/dev/fakeUSB0,461,465,464,472,1862,3467044,20940,heartbeat
/dev/fakeUSB0,471,476,467,480,1894,3587236,20960,heartbeat
/dev/fakeUSB0,454,484,471,479,1888,3564544,20980,heartbeat
/dev/fakeUSB0,480,486,459,482,1907,3636649,21000,heartbeat
/dev/fakeUSB0,473,468,454,493,1888,3564544,21020,heartbeat
/dev/fakeUSB0,469,468,457,483,1877,3523129,21040,heartbeat
/dev/fakeUSB0,473,469,455,466,1863,3470769,21060,heartbeat
/dev/fakeUSB0,468,470,451,455,1844,3400336,21080,heartbeat
/dev/fakeUSB0,472,457,464,453,1846,3407716,21100,heartbeat
/dev/fakeUSB0,468,468,445,454,1835,3367225,21120,heartbeat
/dev/fakeUSB0,464,457,461,471,1853,3433609,21140,heartbeat
/dev/fakeUSB0,468,460,450,465,1843,3396649,21160,heartbeat
/dev/fakeUSB0,460,454,462,461,1837,3374569,21180,heartbeat
/dev/fakeUSB0,437,464,461,456,1818,3305124,21200,heartbeat
/dev/fakeUSB0,447,465,456,469,1837,3374569,21220,heartbeat
/dev/fakeUSB0,454,465,465,459,1843,3396649,21240,heartbeat
/dev/fakeUSB0,449,459,458,460,1826,3334276,21260,heartbeat
/dev/fakeUSB0,455,445,464,445,1809,3272481,21280,heartbeat
/dev/fakeUSB0,451,450,452,463,1816,3297856,21300,heartbeat
/dev/fakeUSB0,457,444,458,468,1827,3337929,21320,heartbeat
/dev/fakeUSB0,445,447,453,459,1804,3254416,21340,heartbeat
/dev/fakeUSB0,473,456,468,474,1871,3500641,21360,heartbeat
/dev/fakeUSB0,487,469,468,471,1895,3591025,21380,heartbeat
/dev/fakeUSB0,533,484,463,495,1975,3900625,21400,heartbeat
/dev/fakeUSB0,545,501,483,515,2044,4177936,21420,heartbeat
/dev/fakeUSB0,533,509,467,531,2040,4161600,21440,heartbeat
/dev/fakeUSB0,551,504,460,532,2047,4190209,21460,heartbeat
/dev/fakeUSB0,532,515,479,514,2040,4161600,21480,heartbeat
/dev/fakeUSB0,515,490,463,494,1962,3849444,21500,heartbeat
/dev/fakeUSB0,495,505,484,488,1972,3888784,21520,heartbeat
/dev/fakeUSB0,484,483,477,491,1935,3744225,21540,heartbeat
/dev/fakeUSB0,479,468,484,465,1896,3594816,21560,heartbeat
/dev/fakeUSB0,493,475,468,463,1899,3606201,21580,heartbeat
/dev/fakeUSB0,492,465,484,459,1900,3610000,21600,heartbeat
/dev/fakeUSB0,480,465,459,459,1863,3470769,21620,heartbeat
/dev/fakeUSB0,471,454,463,453,1841,3389281,21640,heartbeat
/dev/fakeUSB0,474,460,468,445,1847,3411409,21660,heartbeat
/dev/fakeUSB0,473,469,474,454,1870,3496900,21680,heartbeat
/dev/fakeUSB0,475,460,477,468,1880,3534400,21700,heartbeat
/dev/fakeUSB0,481,463,468,475,1887,3560769,21720,heartbeat
/dev/fakeUSB0,464,467,476,477,1884,3549456,21740,heartbeat
/dev/fakeUSB0,476,457,481,480,1894,3587236,21760,heartbeat
/dev/fakeUSB0,474,460,466,472,1872,3504384,21780,heartbeat
/dev/fakeUSB0,467,460,463,452,1842,3392964,21800,heartbeat
/dev/fakeUSB0,460,456,455,452,1823,3323329,21820,heartbeat
/dev/fakeUSB0,457,450,464,456,1827,3337929,21840,heartbeat
/dev/fakeUSB0,454,457,469,460,1840,3385600,21860,heartbeat
/dev/fakeUSB0,446,453,478,456,1833,3359889,21880,heartbeat
/dev/fakeUSB0,444,453,468,462,1827,3337929,21900,heartbeat
/dev/fakeUSB0,455,460,463,449,1827,3337929,21920,heartbeat
/dev/fakeUSB0,457,457,468,454,1836,3370896,21940,heartbeat
/dev/fakeUSB0,442,450,466,439,1797,3229209,21960,heartbeat
/dev/fakeUSB0,433,463,464,453,1813,3286969,21980,heartbeat
/dev/fakeUSB0,424,444,472,461,1801,3243601,22000,heartbeat
/dev/fakeUSB0,418,441,473,443,1775,3150625,22020,heartbeat
/dev/fakeUSB0,425,444,468,445,1782,3175524,22040,heartbeat
/dev/fakeUSB0,447,454,452,445,1798,3232804,22060,heartbeat
/dev/fakeUSB0,475,467,457,468,1867,3485689,22080,heartbeat
/dev/fakeUSB0,501,484,473,471,1929,3721041,22100,heartbeat
/dev/fakeUSB0,539,492,473,507,2011,4044121,22120,heartbeat
/dev/fakeUSB0,556,504,484,524,2068,4276624,22140,heartbeat
/dev/fakeUSB0,547,515,504,506,2072,4293184,22160,heartbeat
/dev/fakeUSB0,543,500,495,499,2037,4149369,22180,heartbeat
/dev/fakeUSB0,542,500,487,498,2027,4108729,22200,heartbeat
/dev/fakeUSB0,524,495,485,479,1983,3932289,22220,heartbeat
/dev/fakeUSB0,504,468,480,457,1909,3644281,22240,heartbeat
/dev/fakeUSB0,492,466,472,463,1893,3583449,22260,heartbeat
/dev/fakeUSB0,475,462,466,456,1859,3455881,22280,heartbeat
/dev/fakeUSB0,461,459,488,444,1852,3429904,22300,heartbeat
/dev/fakeUSB0,459,457,472,437,1825,3330625,22320,heartbeat
/dev/fakeUSB0,459,456,462,428,1805,3258025,22340,heartbeat
/dev/fakeUSB0,465,468,487,447,1867,3485689,22360,heartbeat
/dev/fakeUSB0,476,470,487,451,1884,3549456,22380,heartbeat
/dev/fakeUSB0,479,472,480,464,1895,3591025,22400,heartbeat
/dev/fakeUSB0,459,471,484,447,1861,3463321,22420,heartbeat
/dev/fakeUSB0,466,454,464,453,1837,3374569,22440,heartbeat
/dev/fakeUSB0,459,472,475,447,1853,3433609,22460,heartbeat
/dev/fakeUSB0,459,460,476,452,1847,3411409,22480,heartbeat
/dev/fakeUSB0,447,449,464,456,1816,3297856,22500,heartbeat
/dev/fakeUSB0,437,452,472,445,1806,3261636,22520,heartbeat
/dev/fakeUSB0,436,445,467,432,1780,3168400,22540,heartbeat
/dev/fakeUSB0,433,454,453,446,1786,3189796,22560,heartbeat
/dev/fakeUSB0,435,457,467,444,1803,3250809,22580,heartbeat
/dev/fakeUSB0,432,456,472,441,1801,3243601,22600,heartbeat
/dev/fakeUSB0,448,438,473,444,1803,3250809,22620,heartbeat
/dev/fakeUSB0,438,459,466,446,1809,3272481,22640,heartbeat
/dev/fakeUSB0,436,436,459,430,1761,3101121,22660,heartbeat
/dev/fakeUSB0,443,446,451,440,1780,3168400,22680,heartbeat
/dev/fakeUSB0,414,454,466,437,1771,3136441,22700,heartbeat
/dev/fakeUSB0,430,444,467,436,1777,3157729,22720,heartbeat
/dev/fakeUSB0,436,431,474,436,1777,3157729,22740,heartbeat
/dev/fakeUSB0,429,451,460,444,1784,3182656,22760,heartbeat
/dev/fakeUSB0,439,457,471,438,1805,3258025,22780,heartbeat
/dev/fakeUSB0,464,468,471,452,1855,3441025,22800,heartbeat
/dev/fakeUSB0,476,484,471,474,1905,3629025,22820,heartbeat
/dev/fakeUSB0,514,498,484,494,1990,3960100,22840,heartbeat
/dev/fakeUSB0,508,500,497,476,1981,3924361,22860,heartbeat
/dev/fakeUSB0,508,495,480,471,1954,3818116,22880,heartbeat
/dev/fakeUSB0,501,484,501,468,1954,3818116,22900,heartbeat
/dev/fakeUSB0,499,479,499,444,1921,3690241,22920,heartbeat
/dev/fakeUSB0,467,486,484,448,1885,3553225,22940,heartbeat
/dev/fakeUSB0,456,469,481,452,1858,3452164,22960,heartbeat
/dev/fakeUSB0,433,453,492,439,1817,3301489,22980,heartbeat
/dev/fakeUSB0,421,443,476,433,1773,3143529,23000,heartbeat
/dev/fakeUSB0,421,444,479,441,1785,3186225,23020,heartbeat
/dev/fakeUSB0,414,442,484,444,1784,3182656,23040,heartbeat
/dev/fakeUSB0,432,442,452,444,1770,3132900,23060,heartbeat
/dev/fakeUSB0,433,459,474,441,1807,3265249,23080,heartbeat
/dev/fakeUSB0,429,440,480,444,1793,3214849,23100,heartbeat
/dev/fakeUSB0,431,445,461,433,1770,3132900,23120,heartbeat
/dev/fakeUSB0,436,464,481,445,1826,3334276,23140,heartbeat
/dev/fakeUSB0,435,465,468,457,1825,3330625,23160,heartbeat
/dev/fakeUSB0,423,461,462,448,1794,3218436,23180,heartbeat
/dev/fakeUSB0,423,450,471,447,1791,3207681,23200,heartbeat
/dev/fakeUSB0,431,459,468,443,1801,3243601,23220,heartbeat
/dev/fakeUSB0,426,435,479,443,1783,3179089,23240,heartbeat
/dev/fakeUSB0,428,446,481,444,1799,3236401,23260,heartbeat
/dev/fakeUSB0,422,436,453,439,1750,3062500,23280,heartbeat
/dev/fakeUSB0,427,445,468,425,1765,3115225,23300,heartbeat
/dev/fakeUSB0,431,442,469,428,1770,3132900,23320,heartbeat
/dev/fakeUSB0,421,442,476,437,1776,3154176,23340,heartbeat
/dev/fakeUSB0,428,436,448,448,1760,3097600,23360,heartbeat
/dev/fakeUSB0,423,447,468,441,1779,3164841,23380,heartbeat
/dev/fakeUSB0,416,447,453,446,1762,3104644,23400,heartbeat
/dev/fakeUSB0,407,428,458,453,1746,3048516,23420,heartbeat
/dev/fakeUSB0,409,431,462,449,1751,3066001,23440,heartbeat
/dev/fakeUSB0,414,437,452,447,1750,3062500,23460,heartbeat
/dev/fakeUSB0,420,445,446,436,1747,3052009,23480,heartbeat
/dev/fakeUSB0,438,460,474,462,1834,3363556,23500,heartbeat
/dev/fakeUSB0,463,484,479,465,1891,3575881,23520,heartbeat
/dev/fakeUSB0,485,473,500,472,1930,3724900,23540,heartbeat
/dev/fakeUSB0,491,476,490,476,1933,3736489,23560,heartbeat
/dev/fakeUSB0,467,491,492,481,1931,3728761,23580,heartbeat
/dev/fakeUSB0,464,491,499,468,1922,3694084,23600,heartbeat
/dev/fakeUSB0,458,476,492,451,1877,3523129,23620,heartbeat
/dev/fakeUSB0,444,475,490,457,1866,3481956,23640,heartbeat
/dev/fakeUSB0,430,455,462,445,1792,3211264,23660,heartbeat
/dev/fakeUSB0,447,456,469,436,1808,3268864,23680,heartbeat
/dev/fakeUSB0,445,449,463,446,1803,3250809,23700,heartbeat
/dev/fakeUSB0,427,441,469,445,1782,3175524,23720,heartbeat
/dev/fakeUSB0,434,442,466,443,1785,3186225,23740,heartbeat
/dev/fakeUSB0,431,464,454,450,1799,3236401,23760,heartbeat
/dev/fakeUSB0,449,455,460,449,1813,3286969,23780,heartbeat
/dev/fakeUSB0,455,456,463,448,1822,3319684,23800,heartbeat
/dev/fakeUSB0,444,462,484,459,1849,3418801,23820,heartbeat
/dev/fakeUSB0,451,452,476,441,1820,3312400,23840,heartbeat
/dev/fakeUSB0,444,453,483,454,1834,3363556,23860,heartbeat
/dev/fakeUSB0,432,448,464,457,1801,3243601,23880,heartbeat
/dev/fakeUSB0,443,440,474,443,1800,3240000,23900,heartbeat
/dev/fakeUSB0,446,458,462,435,1801,3243601,23920,heartbeat
/dev/fakeUSB0,451,445,470,450,1816,3297856,23940,heartbeat
/dev/fakeUSB0,434,448,472,440,1794,3218436,23960,heartbeat
/dev/fakeUSB0,450,452,464,430,1796,3225616,23980,heartbeat
/dev/fakeUSB0,444,452,467,447,1810,3276100,24000,heartbeat
/dev/fakeUSB0,441,442,460,455,1798,3232804,24020,heartbeat
/dev/fakeUSB0,452,447,455,455,1809,3272481,24040,heartbeat
/dev/fakeUSB0,448,443,453,460,1804,3254416,24060,heartbeat
/dev/fakeUSB0,452,443,463,446,1804,3254416,24080,heartbeat
/dev/fakeUSB0,457,444,432,446,1779,3164841,24100,heartbeat
/dev/fakeUSB0,444,440,448,452,1784,3182656,24120,heartbeat
/dev/fakeUSB0,431,437,459,440,1767,3122289,24140,heartbeat
/dev/fakeUSB0,424,442,461,439,1766,3118756,24160,heartbeat
/dev/fakeUSB0,459,439,468,449,1815,3294225,24180,heartbeat
/dev/fakeUSB0,475,462,452,455,1844,3400336,24200,heartbeat
/dev/fakeUSB0,492,474,492,481,1939,3759721,24220,heartbeat
/dev/fakeUSB0,523,486,504,483,1996,3984016,24240,heartbeat
/dev/fakeUSB0,520,484,501,474,1979,3916441,24260,heartbeat
/dev/fakeUSB0,512,492,481,484,1969,3876961,24280,heartbeat
/dev/fakeUSB0,498,481,490,475,1944,3779136,24300,heartbeat
/dev/fakeUSB0,479,480,484,460,1903,3621409,24320,heartbeat
/dev/fakeUSB0,464,458,478,449,1849,3418801,24340,heartbeat
/dev/fakeUSB0,462,463,479,452,1856,3444736,24360,heartbeat
/dev/fakeUSB0,459,462,472,454,1847,3411409,24380,heartbeat
/dev/fakeUSB0,466,466,475,451,1858,3452164,24400,heartbeat
/dev/fakeUSB0,454,460,484,447,1845,3404025,24420,heartbeat
/dev/fakeUSB0,453,454,467,453,1827,3337929,24440,heartbeat
/dev/fakeUSB0,455,450,464,461,1830,3348900,24460,heartbeat
/dev/fakeUSB0,460,441,467,461,1829,3345241,24480,heartbeat
/dev/fakeUSB0,461,453,476,466,1856,3444736,24500,heartbeat
/dev/fakeUSB0,452,444,476,459,1831,3352561,24520,heartbeat
/dev/fakeUSB0,460,452,468,454,1834,3363556,24540,heartbeat
/dev/fakeUSB0,457,460,470,455,1842,3392964,24560,heartbeat
/dev/fakeUSB0,452,458,464,438,1812,3283344,24580,heartbeat
/dev/fakeUSB0,438,452,472,448,1810,3276100,24600,heartbeat
/dev/fakeUSB0,438,459,449,444,1790,3204100,24620,heartbeat
/dev/fakeUSB0,443,451,450,428,1772,3139984,24640,heartbeat
/dev/fakeUSB0,446,451,464,430,1791,3207681,24660,heartbeat
/dev/fakeUSB0,441,443,453,440,1777,3157729,24680,heartbeat
/dev/fakeUSB0,446,450,449,436,1781,3171961,24700,heartbeat
/dev/fakeUSB0,441,445,450,443,1779,3164841,24720,heartbeat
/dev/fakeUSB0,436,449,464,446,1795,3222025,24740,heartbeat
/dev/fakeUSB0,440,442,459,450,1791,3207681,24760,heartbeat
/dev/fakeUSB0,435,449,464,440,1788,3196944,24780,heartbeat
/dev/fakeUSB0,444,458,437,441,1780,3168400,24800,heartbeat
/dev/fakeUSB0,430,436,444,440,1750,3062500,24820,heartbeat
/dev/fakeUSB0,431,445,449,448,1773,3143529,24840,heartbeat
/dev/fakeUSB0,456,432,451,447,1786,3189796,24860,heartbeat
/dev/fakeUSB0,471,436,441,449,1797,3229209,24880,heartbeat
/dev/fakeUSB0,495,457,468,453,1873,3508129,24900,heartbeat
/dev/fakeUSB0,501,464,476,464,1905,3629025,24920,heartbeat
/dev/fakeUSB0,502,474,480,472,1928,3717184,24940,heartbeat
/dev/fakeUSB0,504,492,490,481,1967,3869089,24960,heartbeat
/dev/fakeUSB0,481,492,479,477,1929,3721041,24980,heartbeat
/dev/fakeUSB0,492,483,494,467,1936,3748096,25000,heartbeat
/dev/fakeUSB0,477,476,484,464,1901,3613801,25020,heartbeat
/dev/fakeUSB0,461,484,482,463,1890,3572100,25040,heartbeat
/dev/fakeUSB0,468,476,467,466,1877,3523129,25060,heartbeat
/dev/fakeUSB0,461,467,467,461,1856,3444736,25080,heartbeat
/dev/fakeUSB0,456,461,465,457,1839,3381921,25100,heartbeat
/dev/fakeUSB0,466,463,459,466,1854,3437316,25120,heartbeat
/dev/fakeUSB0,460,460,472,452,1844,3400336,25140,heartbeat
/dev/fakeUSB0,468,452,454,458,1832,3356224,25160,heartbeat
/dev/fakeUSB0,465,460,472,469,1866,3481956,25180,heartbeat
/dev/fakeUSB0,448,452,456,471,1827,3337929,25200,heartbeat
/dev/fakeUSB0,459,471,479,460,1869,3493161,25220,heartbeat
/dev/fakeUSB0,453,461,464,457,1835,3367225,25240,heartbeat
/dev/fakeUSB0,467,448,460,453,1828,3341584,25260,heartbeat
/dev/fakeUSB0,452,458,463,452,1825,3330625,25280,heartbeat
/dev/fakeUSB0,448,456,454,448,1806,3261636,25300,heartbeat
/dev/fakeUSB0,448,449,466,447,1810,3276100,25320,heartbeat
/dev/fakeUSB0,447,452,466,455,1820,3312400,25340,heartbeat
/dev/fakeUSB0,439,452,452,439,1782,3175524,25360,heartbeat
/dev/fakeUSB0,441,446,454,450,1791,3207681,25380,heartbeat
/dev/fakeUSB0,453,445,456,428,1782,3175524,25400,heartbeat
/dev/fakeUSB0,444,436,444,444,1768,3125824,25420,heartbeat
/dev/fakeUSB0,442,448,455,436,1781,3171961,25440,heartbeat
/dev/fakeUSB0,442,450,459,446,1797,3229209,25460,heartbeat
/dev/fakeUSB0,456,436,457,449,1798,3232804,25480,heartbeat
/dev/fakeUSB0,458,444,445,458,1805,3258025,25500,heartbeat
/dev/fakeUSB0,456,449,435,458,1798,3232804,25520,heartbeat
/dev/fakeUSB0,449,457,444,452,1802,3247204,25540,heartbeat
/dev/fakeUSB0,444,454,463,445,1806,3261636,25560,heartbeat
/dev/fakeUSB0,451,461,452,464,1828,3341584,25580,heartbeat
/dev/fakeUSB0,480,467,449,465,1861,3463321,25600,heartbeat
/dev/fakeUSB0,490,482,468,484,1924,3701776,25620,heartbeat
/dev/fakeUSB0,500,484,471,488,1943,3775249,25640,heartbeat
/dev/fakeUSB0,503,494,489,505,1991,3964081,25660,heartbeat
/dev/fakeUSB0,492,505,476,484,1957,3829849,25680,heartbeat
/dev/fakeUSB0,484,499,493,482,1958,3833764,25700,heartbeat
/dev/fakeUSB0,479,484,491,453,1907,3636649,25720,heartbeat
/dev/fakeUSB0,466,488,476,476,1906,3632836,25740,heartbeat
/dev/fakeUSB0,460,468,476,468,1872,3504384,25760,heartbeat
/dev/fakeUSB0,444,458,469,468,1839,3381921,25780,heartbeat
/dev/fakeUSB0,433,457,449,461,1800,3240000,25800,heartbeat
/dev/fakeUSB0,449,457,461,471,1838,3378244,25820,heartbeat
/dev/fakeUSB0,433,465,459,455,1812,3283344,25840,heartbeat
/dev/fakeUSB0,442,471,448,454,1815,3294225,25860,heartbeat
/dev/fakeUSB0,428,469,463,444,1804,3254416,25880,heartbeat
/dev/fakeUSB0,438,469,461,465,1833,3359889,25900,heartbeat
/dev/fakeUSB0,432,473,452,436,1793,3214849,25920,heartbeat
/dev/fakeUSB0,445,460,461,454,1820,3312400,25940,heartbeat
/dev/fakeUSB0,440,462,444,451,1797,3229209,25960,heartbeat
/dev/fakeUSB0,445,463,456,468,1832,3356224,25980,heartbeat
/dev/fakeUSB0,436,468,461,452,1817,3301489,26000,heartbeat
/dev/fakeUSB0,427,460,455,452,1794,3218436,26020,heartbeat
/dev/fakeUSB0,420,459,464,447,1790,3204100,26040,heartbeat
/dev/fakeUSB0,421,453,451,452,1777,3157729,26060,heartbeat
/dev/fakeUSB0,430,452,458,459,1799,3236401,26080,heartbeat
/dev/fakeUSB0,428,448,453,446,1775,3150625,26100,heartbeat
/dev/fakeUSB0,436,454,451,452,1793,3214849,26120,heartbeat
/dev/fakeUSB0,432,454,448,454,1788,3196944,26140,heartbeat
/dev/fakeUSB0,419,461,446,463,1789,3200521,26160,heartbeat
/dev/fakeUSB0,421,453,448,465,1787,3193369,26180,heartbeat
/dev/fakeUSB0,424,447,454,460,1785,3186225,26200,heartbeat
/dev/fakeUSB0,419,443,466,451,1779,3164841,26220,heartbeat
/dev/fakeUSB0,419,452,453,448,1772,3139984,26240,heartbeat
/dev/fakeUSB0,430,448,449,439,1766,3118756,26260,heartbeat
/dev/fakeUSB0,432,457,448,472,1809,3272481,26280,heartbeat
/dev/fakeUSB0,462,475,457,476,1870,3496900,26300,heartbeat
/dev/fakeUSB0,479,488,483,492,1942,3771364,26320,heartbeat
/dev/fakeUSB0,488,506,486,508,1988,3952144,26340,heartbeat
/dev/fakeUSB0,485,517,490,491,1983,3932289,26360,heartbeat
/dev/fakeUSB0,477,528,491,488,1984,3936256,26380,heartbeat
/dev/fakeUSB0,483,503,489,490,1965,3861225,26400,heartbeat
/dev/fakeUSB0,457,495,482,460,1894,3587236,26420,heartbeat
/dev/fakeUSB0,454,484,479,468,1885,3553225,26440,heartbeat
/dev/fakeUSB0,447,492,461,460,1860,3459600,26460,heartbeat
/dev/fakeUSB0,450,466,456,464,1836,3370896,26480,heartbeat
/dev/fakeUSB0,451,468,468,453,1840,3385600,26500,heartbeat
/dev/fakeUSB0,444,461,472,463,1840,3385600,26520,heartbeat
/dev/fakeUSB0,452,473,465,471,1861,3463321,26540,heartbeat
/dev/fakeUSB0,449,452,473,460,1834,3363556,26560,heartbeat
/dev/fakeUSB0,440,467,481,456,1844,3400336,26580,heartbeat
/dev/fakeUSB0,450,473,458,467,1848,3415104,26600,heartbeat
/dev/fakeUSB0,458,468,458,472,1856,3444736,26620,heartbeat
/dev/fakeUSB0,444,461,451,469,1825,3330625,26640,heartbeat
/dev/fakeUSB0,438,458,476,469,1841,3389281,26660,heartbeat
/dev/fakeUSB0,436,461,481,472,1850,3422500,26680,heartbeat
/dev/fakeUSB0,435,468,467,450,1820,3312400,26700,heartbeat
/dev/fakeUSB0,425,443,464,445,1777,3157729,26720,heartbeat
/dev/fakeUSB0,440,461,462,464,1827,3337929,26740,heartbeat
/dev/fakeUSB0,441,443,466,455,1805,3258025,26760,heartbeat
/dev/fakeUSB0,436,459,450,451,1796,3225616,26780,heartbeat
/dev/fakeUSB0,431,447,442,463,1783,3179089,26800,heartbeat
/dev/fakeUSB0,444,443,438,460,1785,3186225,26820,heartbeat
/dev/fakeUSB0,447,460,437,468,1812,3283344,26840,heartbeat
/dev/fakeUSB0,440,451,462,469,1822,3319684,26860,heartbeat
/dev/fakeUSB0,458,462,454,468,1842,3392964,26880,heartbeat
/dev/fakeUSB0,442,444,451,460,1797,3229209,26900,heartbeat
/dev/fakeUSB0,440,461,451,463,1815,3294225,26920,heartbeat
/dev/fakeUSB0,448,460,463,448,1819,3308761,26940,heartbeat
/dev/fakeUSB0,464,452,456,473,1845,3404025,26960,heartbeat
/dev/fakeUSB0,480,465,475,486,1906,3632836,26980,heartbeat
/dev/fakeUSB0,511,486,471,501,1969,3876961,27000,heartbeat
/dev/fakeUSB0,515,496,471,493,1975,3900625,27020,heartbeat
/dev/fakeUSB0,518,496,499,492,2005,4020025,27040,heartbeat
/dev/fakeUSB0,526,519,486,476,2007,4028049,27060,heartbeat
/dev/fakeUSB0,527,516,490,479,2012,4048144,27080,heartbeat
/dev/fakeUSB0,501,491,489,472,1953,3814209,27100,heartbeat
/dev/fakeUSB0,496,477,493,471,1937,3751969,27120,heartbeat
/dev/fakeUSB0,492,475,469,473,1909,3644281,27140,heartbeat
/dev/fakeUSB0,483,475,466,452,1876,3519376,27160,heartbeat
/dev/fakeUSB0,479,460,456,460,1855,3441025,27180,heartbeat
/dev/fakeUSB0,476,445,459,460,1840,3385600,27200,heartbeat
/dev/fakeUSB0,475,453,475,460,1863,3470769,27220,heartbeat
/dev/fakeUSB0,475,458,449,471,1853,3433609,27240,heartbeat
/dev/fakeUSB0,471,453,445,455,1824,3326976,27260,heartbeat
/dev/fakeUSB0,467,452,471,455,1845,3404025,27280,heartbeat
/dev/fakeUSB0,477,456,474,480,1887,3560769,27300,heartbeat
/dev/fakeUSB0,473,467,473,465,1878,3526884,27320,heartbeat
/dev/fakeUSB0,478,452,471,472,1873,3508129,27340,heartbeat
/dev/fakeUSB0,483,462,466,449,1860,3459600,27360,heartbeat
/dev/fakeUSB0,466,463,468,461,1858,3452164,27380,heartbeat
/dev/fakeUSB0,477,457,449,446,1829,3345241,27400,heartbeat
/dev/fakeUSB0,452,449,460,446,1807,3265249,27420,heartbeat
/dev/fakeUSB0,458,452,456,462,1828,3341584,27440,heartbeat
/dev/fakeUSB0,455,452,461,448,1816,3297856,27460,heartbeat
/dev/fakeUSB0,469,446,456,444,1815,3294225,27480,heartbeat
/dev/fakeUSB0,477,437,453,442,1809,3272481,27500,heartbeat
/dev/fakeUSB0,473,444,458,459,1834,3363556,27520,heartbeat
/dev/fakeUSB0,468,439,476,465,1848,3415104,27540,heartbeat
/dev/fakeUSB0,469,441,467,437,1814,3290596,27560,heartbeat
/dev/fakeUSB0,453,434,470,444,1801,3243601,27580,heartbeat
/dev/fakeUSB0,464,442,463,444,1813,3286969,27600,heartbeat
/dev/fakeUSB0,470,456,457,456,1839,3381921,27620,heartbeat
/dev/fakeUSB0,471,455,452,451,1829,3345241,27640,heartbeat
/dev/fakeUSB0,480,464,464,460,1868,3489424,27660,heartbeat
/dev/fakeUSB0,509,487,481,476,1953,3814209,27680,heartbeat
/dev/fakeUSB0,530,500,496,480,2006,4024036,27700,heartbeat
/dev/fakeUSB0,542,523,492,484,2041,4165681,27720,heartbeat
/dev/fakeUSB0,567,520,497,492,2076,4309776,27740,heartbeat
/dev/fakeUSB0,548,516,500,492,2056,4227136,27760,heartbeat
/dev/fakeUSB0,550,507,493,484,2034,4137156,27780,heartbeat
/dev/fakeUSB0,510,484,485,474,1953,3814209,27800,heartbeat
/dev/fakeUSB0,502,480,477,470,1929,3721041,27820,heartbeat
/dev/fakeUSB0,491,475,468,466,1900,3610000,27840,heartbeat
/dev/fakeUSB0,481,456,456,474,1867,3485689,27860,heartbeat
/dev/fakeUSB0,466,458,459,451,1834,3363556,27880,heartbeat
/dev/fakeUSB0,478,434,466,461,1839,3381921,27900,heartbeat
/dev/fakeUSB0,459,437,468,461,1825,3330625,27920,heartbeat
/dev/fakeUSB0,472,450,466,474,1862,3467044,27940,heartbeat
/dev/fakeUSB0,464,452,461,447,1824,3326976,27960,heartbeat
/dev/fakeUSB0,475,448,466,457,1846,3407716,27980,heartbeat
/dev/fakeUSB0,477,458,476,467,1878,3526884,28000,heartbeat
/dev/fakeUSB0,479,459,461,449,1848,3415104,28020,heartbeat
/dev/fakeUSB0,459,450,453,459,1821,3316041,28040,heartbeat
/dev/fakeUSB0,477,440,462,459,1838,3378244,28060,heartbeat
/dev/fakeUSB0,472,457,460,470,1859,3455881,28080,heartbeat
/dev/fakeUSB0,461,445,479,445,1830,3348900,28100,heartbeat
/dev/fakeUSB0,452,443,468,446,1809,3272481,28120,heartbeat
/dev/fakeUSB0,444,444,465,446,1799,3236401,28140,heartbeat
/dev/fakeUSB0,456,451,456,444,1807,3265249,28160,heartbeat
/dev/fakeUSB0,444,445,452,444,1785,3186225,28180,heartbeat
/dev/fakeUSB0,457,451,444,436,1788,3196944,28200,heartbeat
/dev/fakeUSB0,453,444,462,452,1811,3279721,28220,heartbeat
/dev/fakeUSB0,457,449,452,458,1816,3297856,28240,heartbeat
/dev/fakeUSB0,453,444,452,463,1812,3283344,28260,heartbeat
/dev/fakeUSB0,458,452,463,449,1822,3319684,28280,heartbeat
/dev/fakeUSB0,460,443,467,449,1819,3308761,28300,heartbeat
/dev/fakeUSB0,448,438,449,459,1794,3218436,28320,heartbeat
/dev/fakeUSB0,473,444,477,458,1852,3429904,28340,heartbeat
/dev/fakeUSB0,488,469,470,470,1897,3598609,28360,heartbeat
/dev/fakeUSB0,505,476,472,484,1937,3751969,28380,heartbeat
/dev/fakeUSB0,557,492,494,495,2038,4153444,28400,heartbeat
/dev/fakeUSB0,540,500,492,484,2016,4064256,28420,heartbeat
/dev/fakeUSB0,548,515,493,484,2040,4161600,28440,heartbeat
/dev/fakeUSB0,523,508,506,483,2020,4080400,28460,heartbeat
/dev/fakeUSB0,502,481,489,461,1933,3736489,28480,heartbeat
/dev/fakeUSB0,485,465,468,467,1885,3553225,28500,heartbeat
/dev/fakeUSB0,476,452,488,448,1864,3474496,28520,heartbeat
/dev/fakeUSB0,480,454,467,460,1861,3463321,28540,heartbeat
/dev/fakeUSB0,452,444,456,432,1784,3182656,28560,heartbeat
/dev/fakeUSB0,456,439,471,446,1812,3283344,28580,heartbeat
/dev/fakeUSB0,437,440,475,450,1802,3247204,28600,heartbeat
/dev/fakeUSB0,456,444,476,446,1822,3319684,28620,heartbeat
/dev/fakeUSB0,445,450,452,444,1791,3207681,28640,heartbeat
/dev/fakeUSB0,454,453,458,458,1823,3323329,28660,heartbeat
/dev/fakeUSB0,452,460,460,459,1831,3352561,28680,heartbeat
/dev/fakeUSB0,456,456,480,455,1847,3411409,28700,heartbeat
/dev/fakeUSB0,448,453,464,437,1802,3247204,28720,heartbeat
/dev/fakeUSB0,444,438,483,448,1813,3286969,28740,heartbeat
/dev/fakeUSB0,440,443,465,437,1785,3186225,28760,heartbeat
/dev/fakeUSB0,430,444,448,439,1761,3101121,28780,heartbeat
/dev/fakeUSB0,416,447,445,450,1758,3090564,28800,heartbeat
/dev/fakeUSB0,415,441,444,446,1746,3048516,28820,heartbeat
/dev/fakeUSB0,422,439,467,447,1775,3150625,28840,heartbeat
/dev/fakeUSB0,422,443,447,436,1748,3055504,28860,heartbeat
/dev/fakeUSB0,420,432,451,440,1743,3038049,28880,heartbeat
/dev/fakeUSB0,421,439,470,448,1778,3161284,28900,heartbeat
/dev/fakeUSB0,414,454,456,433,1757,3087049,28920,heartbeat
/dev/fakeUSB0,414,433,452,449,1748,3055504,28940,heartbeat
/dev/fakeUSB0,408,435,440,450,1733,3003289,28960,heartbeat
/dev/fakeUSB0,423,436,460,433,1752,3069504,28980,heartbeat
/dev/fakeUSB0,427,429,454,443,1753,3073009,29000,heartbeat
/dev/fakeUSB0,429,442,472,464,1807,3265249,29020,heartbeat
/dev/fakeUSB0,453,465,456,481,1855,3441025,29040,heartbeat
/dev/fakeUSB0,472,484,463,476,1895,3591025,29060,heartbeat
/dev/fakeUSB0,496,500,487,497,1980,3920400,29080,heartbeat
/dev/fakeUSB0,516,494,495,488,1993,3972049,29100,heartbeat
/dev/fakeUSB0,524,489,476,475,1964,3857296,29120,heartbeat
/dev/fakeUSB0,500,494,496,465,1955,3822025,29140,heartbeat
/dev/fakeUSB0,502,496,480,460,1938,3755844,29160,heartbeat
/dev/fakeUSB0,490,464,469,456,1879,3530641,29180,heartbeat
/dev/fakeUSB0,472,456,471,444,1843,3396649,29200,heartbeat
/dev/fakeUSB0,457,453,481,445,1836,3370896,29220,heartbeat
/dev/fakeUSB0,457,441,457,436,1791,3207681,29240,heartbeat
/dev/fakeUSB0,457,446,464,445,1812,3283344,29260,heartbeat
/dev/fakeUSB0,465,442,472,433,1812,3283344,29280,heartbeat
/dev/fakeUSB0,448,456,478,445,1827,3337929,29300,heartbeat
/dev/fakeUSB0,438,439,468,455,1800,3240000,29320,heartbeat
/dev/fakeUSB0,442,445,452,448,1787,3193369,29340,heartbeat
/dev/fakeUSB0,444,452,476,443,1815,3294225,29360,heartbeat
/dev/fakeUSB0,456,455,478,449,1838,3378244,29380,heartbeat
/dev/fakeUSB0,436,467,452,446,1801,3243601,29400,heartbeat
/dev/fakeUSB0,436,451,465,450,1802,3247204,29420,heartbeat
/dev/fakeUSB0,425,460,464,448,1797,3229209,29440,heartbeat
/dev/fakeUSB0,437,446,456,447,1786,3189796,29460,heartbeat
/dev/fakeUSB0,440,432,467,448,1787,3193369,29480,heartbeat
/dev/fakeUSB0,436,444,474,436,1790,3204100,29500,heartbeat
/dev/fakeUSB0,436,451,453,439,1779,3164841,29520,heartbeat
/dev/fakeUSB0,433,446,452,435,1766,3118756,29540,heartbeat
/dev/fakeUSB0,445,434,456,447,1782,3175524,29560,heartbeat
/dev/fakeUSB0,444,453,462,444,1803,3250809,29580,heartbeat
/dev/fakeUSB0,445,444,449,439,1777,3157729,29600,heartbeat
/dev/fakeUSB0,458,447,443,436,1784,3182656,29620,heartbeat
/dev/fakeUSB0,466,444,439,443,1792,3211264,29640,heartbeat
/dev/fakeUSB0,464,455,443,441,1803,3250809,29660,heartbeat
/dev/fakeUSB0,466,437,463,444,1810,3276100,29680,heartbeat
/dev/fakeUSB0,467,454,473,450,1844,3400336,29700,heartbeat
/dev/fakeUSB0,482,452,459,454,1847,3411409,29720,heartbeat
/dev/fakeUSB0,506,467,479,461,1913,3659569,29740,heartbeat
/dev/fakeUSB0,540,495,474,483,1992,3968064,29760,heartbeat
/dev/fakeUSB0,543,503,487,487,2020,4080400,29780,heartbeat
/dev/fakeUSB0,545,509,483,470,2007,4028049,29800,heartbeat
/dev/fakeUSB0,525,500,495,466,1986,3944196,29820,heartbeat
/dev/fakeUSB0,521,498,489,476,1984,3936256,29840,heartbeat
/dev/fakeUSB0,510,486,471,465,1932,3732624,29860,heartbeat
/dev/fakeUSB0,502,461,480,436,1879,3530641,29880,heartbeat
/dev/fakeUSB0,488,464,468,444,1864,3474496,29900,heartbeat
/dev/fakeUSB0,491,470,470,439,1870,3496900,29920,heartbeat
/dev/fakeUSB0,472,456,451,446,1825,3330625,29940,heartbeat
/dev/fakeUSB0,481,460,463,437,1841,3389281,29960,heartbeat
/dev/fakeUSB0,480,457,461,453,1851,3426201,29980,heartbeat
/dev/fakeUSB0,482,467,464,448,1861,3463321,30000,heartbeat
/dev/fakeUSB0,480,458,463,445,1846,3407716,30020,heartbeat
/dev/fakeUSB0,479,457,461,464,1861,3463321,30040,heartbeat
/dev/fakeUSB0,472,450,477,447,1846,3407716,30060,heartbeat
/dev/fakeUSB0,475,467,481,466,1889,3568321,30080,heartbeat
/dev/fakeUSB0,482,453,473,442,1850,3422500,30100,heartbeat
/dev/fakeUSB0,461,442,454,443,1800,3240000,30120,heartbeat
/dev/fakeUSB0,468,434,462,437,1801,3243601,30140,heartbeat
/dev/fakeUSB0,460,454,456,447,1817,3301489,30160,heartbeat
/dev/fakeUSB0,446,445,460,443,1794,3218436,30180,heartbeat
/dev/fakeUSB0,452,445,449,436,1782,3175524,30200,heartbeat
/dev/fakeUSB0,452,452,450,450,1804,3254416,30220,heartbeat
/dev/fakeUSB0,459,446,457,449,1811,3279721,30240,heartbeat
/dev/fakeUSB0,457,432,455,444,1788,3196944,30260,heartbeat
/dev/fakeUSB0,461,453,460,441,1815,3294225,30280,heartbeat
/dev/fakeUSB0,472,452,455,456,1835,3367225,30300,heartbeat
/dev/fakeUSB0,453,446,458,436,1793,3214849,30320,heartbeat
/dev/fakeUSB0,452,445,445,454,1796,3225616,30340,heartbeat
/dev/fakeUSB0,468,444,453,436,1801,3243601,30360,heartbeat
/dev/fakeUSB0,474,446,452,461,1833,3359889,30380,heartbeat
/dev/fakeUSB0,488,472,463,474,1897,3598609,30400,heartbeat
/dev/fakeUSB0,524,483,476,459,1942,3771364,30420,heartbeat
/dev/fakeUSB0,556,502,493,475,2026,4104676,30440,heartbeat
/dev/fakeUSB0,559,517,499,473,2048,4194304,30460,heartbeat
/dev/fakeUSB0,562,510,500,462,2034,4137156,30480,heartbeat
/dev/fakeUSB0,538,496,505,471,2010,4040100,30500,heartbeat
/dev/fakeUSB0,535,504,496,468,2003,4012009,30520,heartbeat
/dev/fakeUSB0,528,481,490,464,1963,3853369,30540,heartbeat
/dev/fakeUSB0,501,475,469,463,1908,3640464,30560,heartbeat
/dev/fakeUSB0,494,463,471,455,1883,3545689,30580,heartbeat
/dev/fakeUSB0,488,460,460,464,1872,3504384,30600,heartbeat
/dev/fakeUSB0,482,449,467,474,1872,3504384,30620,heartbeat
/dev/fakeUSB0,458,440,449,452,1799,3236401,30640,heartbeat
/dev/fakeUSB0,470,468,454,452,1844,3400336,30660,heartbeat
/dev/fakeUSB0,470,457,467,452,1846,3407716,30680,heartbeat
/dev/fakeUSB0,461,451,464,457,1833,3359889,30700,heartbeat
/dev/fakeUSB0,461,443,475,456,1835,3367225,30720,heartbeat
/dev/fakeUSB0,480,458,468,438,1844,3400336,30740,heartbeat
/dev/fakeUSB0,471,460,474,452,1857,3448449,30760,heartbeat
/dev/fakeUSB0,475,450,455,448,1828,3341584,30780,heartbeat
/dev/fakeUSB0,460,459,454,431,1804,3254416,30800,heartbeat
/dev/fakeUSB0,452,463,454,444,1813,3286969,30820,heartbeat
/dev/fakeUSB0,451,448,439,455,1793,3214849,30840,heartbeat
/dev/fakeUSB0,444,450,459,462,1815,3294225,30860,heartbeat
/dev/fakeUSB0,452,447,459,452,1810,3276100,30880,heartbeat
/dev/fakeUSB0,433,456,432,444,1765,3115225,30900,heartbeat
/dev/fakeUSB0,458,456,443,454,1811,3279721,30920,heartbeat
/dev/fakeUSB0,440,453,453,459,1805,3258025,30940,heartbeat
/dev/fakeUSB0,447,456,452,463,1818,3305124,30960,heartbeat
/dev/fakeUSB0,446,444,450,448,1788,3196944,30980,heartbeat
/dev/fakeUSB0,450,444,440,460,1794,3218436,31000,heartbeat
/dev/fakeUSB0,435,436,436,457,1764,3111696,31020,heartbeat
/dev/fakeUSB0,452,440,440,459,1791,3207681,31040,heartbeat
/dev/fakeUSB0,460,454,441,448,1803,3250809,31060,heartbeat
/dev/fakeUSB0,475,455,468,448,1846,3407716,31080,heartbeat
/dev/fakeUSB0,501,471,448,462,1882,3541924,31100,heartbeat
/dev/fakeUSB0,516,488,492,473,1969,3876961,31120,heartbeat
/dev/fakeUSB0,544,499,514,485,2042,4169764,31140,heartbeat
/dev/fakeUSB0,537,517,487,477,2018,4072324,31160,heartbeat
/dev/fakeUSB0,529,503,497,480,2009,4036081,31180,heartbeat
/dev/fakeUSB0,507,507,503,465,1982,3928324,31200,heartbeat
/dev/fakeUSB0,497,498,482,453,1930,3724900,31220,heartbeat
/dev/fakeUSB0,481,472,477,457,1887,3560769,31240,heartbeat
/dev/fakeUSB0,470,459,475,444,1848,3415104,31260,heartbeat
/dev/fakeUSB0,464,467,448,440,1819,3308761,31280,heartbeat
/dev/fakeUSB0,466,454,452,440,1812,3283344,31300,heartbeat
/dev/fakeUSB0,444,442,448,453,1787,3193369,31320,heartbeat
/dev/fakeUSB0,444,448,446,440,1778,3161284,31340,heartbeat
/dev/fakeUSB0,447,452,463,452,1814,3290596,31360,heartbeat
/dev/fakeUSB0,453,466,441,469,1829,3345241,31380,heartbeat
/dev/fakeUSB0,455,450,442,460,1807,3265249,31400,heartbeat
/dev/fakeUSB0,463,455,456,444,1818,3305124,31420,heartbeat
/dev/fakeUSB0,458,451,457,451,1817,3301489,31440,heartbeat
/dev/fakeUSB0,449,465,464,455,1833,3359889,31460,heartbeat
/dev/fakeUSB0,452,457,468,456,1833,3359889,31480,heartbeat
/dev/fakeUSB0,429,461,458,460,1808,3268864,31500,heartbeat
/dev/fakeUSB0,430,448,451,457,1786,3189796,31520,heartbeat
/dev/fakeUSB0,426,451,452,454,1783,3179089,31540,heartbeat
/dev/fakeUSB0,423,446,459,445,1773,3143529,31560,heartbeat
/dev/fakeUSB0,414,432,443,459,1748,3055504,31580,heartbeat
/dev/fakeUSB0,421,447,454,455,1777,3157729,31600,heartbeat
/dev/fakeUSB0,426,444,436,441,1747,3052009,31620,heartbeat
/dev/fakeUSB0,412,437,449,444,1742,3034564,31640,heartbeat
/dev/fakeUSB0,413,433,434,441,1721,2961841,31660,heartbeat
/dev/fakeUSB0,404,450,447,447,1748,3055504,31680,heartbeat
/dev/fakeUSB0,404,448,432,443,1727,2982529,31700,heartbeat
/dev/fakeUSB0,423,439,458,451,1771,3136441,31720,heartbeat
/dev/fakeUSB0,432,448,465,460,1805,3258025,31740,heartbeat
/dev/fakeUSB0,444,450,449,472,1815,3294225,31760,heartbeat
/dev/fakeUSB0,474,467,461,478,1880,3534400,31780,heartbeat
/dev/fakeUSB0,498,482,466,475,1921,3690241,31800,heartbeat
/dev/fakeUSB0,516,499,475,502,1992,3968064,31820,heartbeat
/dev/fakeUSB0,528,500,479,513,2020,4080400,31840,heartbeat
/dev/fakeUSB0,522,498,497,501,2018,4072324,31860,heartbeat
/dev/fakeUSB0,509,494,484,473,1960,3841600,31880,heartbeat
/dev/fakeUSB0,488,495,479,475,1937,3751969,31900,heartbeat
/dev/fakeUSB0,487,476,476,472,1911,3651921,31920,heartbeat
/dev/fakeUSB0,469,461,475,474,1879,3530641,31940,heartbeat
/dev/fakeUSB0,452,464,449,470,1835,3367225,31960,heartbeat
/dev/fakeUSB0,447,463,473,467,1850,3422500,31980,heartbeat
/dev/fakeUSB0,447,452,459,467,1825,3330625,32000,heartbeat
/dev/fakeUSB0,441,455,452,485,1833,3359889,32020,heartbeat
/dev/fakeUSB0,454,470,460,452,1836,3370896,32040,heartbeat
/dev/fakeUSB0,460,462,451,464,1837,3374569,32060,heartbeat
/dev/fakeUSB0,468,475,451,464,1858,3452164,32080,heartbeat
/dev/fakeUSB0,466,455,464,466,1851,3426201,32100,heartbeat
/dev/fakeUSB0,454,472,459,476,1861,3463321,32120,heartbeat
/dev/fakeUSB0,467,474,453,459,1853,3433609,32140,heartbeat
/dev/fakeUSB0,438,471,465,461,1835,3367225,32160,heartbeat
/dev/fakeUSB0,447,455,459,453,1814,3290596,32180,heartbeat
/dev/fakeUSB0,446,448,446,460,1800,3240000,32200,heartbeat
/dev/fakeUSB0,448,451,447,469,1815,3294225,32220,heartbeat
/dev/fakeUSB0,445,443,465,468,1821,3316041,32240,heartbeat
/dev/fakeUSB0,437,444,451,483,1815,3294225,32260,heartbeat
/dev/fakeUSB0,433,447,435,462,1777,3157729,32280,heartbeat
/dev/fakeUSB0,433,449,464,467,1813,3286969,32300,heartbeat
/dev/fakeUSB0,441,438,444,454,1777,3157729,32320,heartbeat
/dev/fakeUSB0,446,451,444,466,1807,3265249,32340,heartbeat
/dev/fakeUSB0,444,444,456,451,1795,3222025,32360,heartbeat
/dev/fakeUSB0,464,450,457,445,1816,3297856,32380,heartbeat
/dev/fakeUSB0,455,441,452,444,1792,3211264,32400,heartbeat
/dev/fakeUSB0,459,443,449,460,1811,3279721,32420,heartbeat
/dev/fakeUSB0,491,457,471,469,1888,3564544,32440,heartbeat
/dev/fakeUSB0,504,484,463,483,1934,3740356,32460,heartbeat
/dev/fakeUSB0,555,508,480,493,2036,4145296,32480,heartbeat
/dev/fakeUSB0,559,518,482,497,2056,4227136,32500,heartbeat
/dev/fakeUSB0,567,534,500,513,2114,4468996,32520,heartbeat
/dev/fakeUSB0,586,510,488,501,2085,4347225,32540,heartbeat
/dev/fakeUSB0,559,516,481,489,2045,4182025,32560,heartbeat
/dev/fakeUSB0,544,499,475,486,2004,4016016,32580,heartbeat
/dev/fakeUSB0,510,497,463,471,1941,3767481,32600,heartbeat
/dev/fakeUSB0,507,491,464,462,1924,3701776,32620,heartbeat
/dev/fakeUSB0,493,476,456,469,1894,3587236,32640,heartbeat
/dev/fakeUSB0,477,460,452,481,1870,3496900,32660,heartbeat
/dev/fakeUSB0,468,467,456,467,1858,3452164,32680,heartbeat
/dev/fakeUSB0,480,454,456,472,1862,3467044,32700,heartbeat
/dev/fakeUSB0,488,463,453,462,1866,3481956,32720,heartbeat
/dev/fakeUSB0,491,468,462,471,1892,3579664,32740,heartbeat
/dev/fakeUSB0,493,476,466,475,1910,3648100,32760,heartbeat
/dev/fakeUSB0,496,466,463,463,1888,3564544,32780,heartbeat
/dev/fakeUSB0,493,456,459,459,1867,3485689,32800,heartbeat
/dev/fakeUSB0,492,469,460,463,1884,3549456,32820,heartbeat
/dev/fakeUSB0,477,465,459,475,1876,3519376,32840,heartbeat
/dev/fakeUSB0,479,453,458,456,1846,3407716,32860,heartbeat
/dev/fakeUSB0,464,455,455,464,1838,3378244,32880,heartbeat
/dev/fakeUSB0,460,452,436,467,1815,3294225,32900,heartbeat
/dev/fakeUSB0,461,460,461,469,1851,3426201,32920,heartbeat
/dev/fakeUSB0,452,453,454,463,1822,3319684,32940,heartbeat
/dev/fakeUSB0,461,450,458,465,1834,3363556,32960,heartbeat
/dev/fakeUSB0,452,447,459,461,1819,3308761,32980,heartbeat
/dev/fakeUSB0,467,449,452,472,1840,3385600,33000,heartbeat
/dev/fakeUSB0,468,457,464,461,1850,3422500,33020,heartbeat
/dev/fakeUSB0,473,441,468,464,1846,3407716,33040,heartbeat
/dev/fakeUSB0,460,437,457,459,1813,3286969,33060,heartbeat
/dev/fakeUSB0,479,445,450,468,1842,3392964,33080,heartbeat
/dev/fakeUSB0,474,455,458,466,1853,3433609,33100,heartbeat
/dev/fakeUSB0,508,466,461,483,1918,3678724,33120,heartbeat
/dev/fakeUSB0,527,500,465,500,1992,3968064,33140,heartbeat
/dev/fakeUSB0,557,524,480,520,2081,4330561,33160,heartbeat
/dev/fakeUSB0,591,525,496,519,2131,4541161,33180,heartbeat
/dev/fakeUSB0,596,528,492,524,2140,4579600,33200,heartbeat
/dev/fakeUSB0,585,529,494,524,2132,4545424,33220,heartbeat
/dev/fakeUSB0,576,509,494,507,2086,4351396,33240,heartbeat
/dev/fakeUSB0,553,495,486,484,2018,4072324,33260,heartbeat
/dev/fakeUSB0,538,497,478,479,1992,3968064,33280,heartbeat
/dev/fakeUSB0,524,489,452,481,1946,3786916,33300,heartbeat
/dev/fakeUSB0,513,459,467,465,1904,3625216,33320,heartbeat
/dev/fakeUSB0,485,460,445,456,1846,3407716,33340,heartbeat
/dev/fakeUSB0,484,461,447,467,1859,3455881,33360,heartbeat
/dev/fakeUSB0,473,468,447,467,1855,3441025,33380,heartbeat
/dev/fakeUSB0,486,460,472,465,1883,3545689,33400,heartbeat
/dev/fakeUSB0,469,461,469,473,1872,3504384,33420,heartbeat
/dev/fakeUSB0,497,472,472,488,1929,3721041,33440,heartbeat
/dev/fakeUSB0,495,464,458,488,1905,3629025,33460,heartbeat
/dev/fakeUSB0,488,457,462,470,1877,3523129,33480,heartbeat
/dev/fakeUSB0,476,448,456,482,1862,3467044,33500,heartbeat
/dev/fakeUSB0,481,446,477,467,1871,3500641,33520,heartbeat
/dev/fakeUSB0,472,453,457,460,1842,3392964,33540,heartbeat
/dev/fakeUSB0,455,453,460,474,1842,3392964,33560,heartbeat
/dev/fakeUSB0,456,442,456,475,1829,3345241,33580,heartbeat
/dev/fakeUSB0,450,441,459,472,1822,3319684,33600,heartbeat
/dev/fakeUSB0,458,446,447,465,1816,3297856,33620,heartbeat
/dev/fakeUSB0,442,449,448,465,1804,3254416,33640,heartbeat
/dev/fakeUSB0,448,440,467,462,1817,3301489,33660,heartbeat
/dev/fakeUSB0,451,445,456,466,1818,3305124,33680,heartbeat
/dev/fakeUSB0,443,458,449,468,1818,3305124,33700,heartbeat
/dev/fakeUSB0,442,440,441,457,1780,3168400,33720,heartbeat
/dev/fakeUSB0,452,441,465,464,1822,3319684,33740,heartbeat
/dev/fakeUSB0,460,452,441,466,1819,3308761,33760,heartbeat
/dev/fakeUSB0,460,444,448,483,1835,3367225,33780,heartbeat
/dev/fakeUSB0,467,469,452,480,1868,3489424,33800,heartbeat
/dev/fakeUSB0,521,490,475,495,1981,3924361,33820,heartbeat
/dev/fakeUSB0,564,516,496,508,2084,4343056,33840,heartbeat
/dev/fakeUSB0,584,511,478,520,2093,4380649,33860,heartbeat
/dev/fakeUSB0,592,527,495,520,2134,4553956,33880,heartbeat
/dev/fakeUSB0,584,521,481,501,2087,4355569,33900,heartbeat
/dev/fakeUSB0,579,507,492,490,2068,4276624,33920,heartbeat
/dev/fakeUSB0,531,484,479,480,1974,3896676,33940,heartbeat
/dev/fakeUSB0,516,476,485,471,1948,3794704,33960,heartbeat
/dev/fakeUSB0,502,456,472,472,1902,3617604,33980,heartbeat
/dev/fakeUSB0,486,463,457,466,1872,3504384,34000,heartbeat
/dev/fakeUSB0,468,460,460,465,1853,3433609,34020,heartbeat
/dev/fakeUSB0,457,446,452,468,1823,3323329,34040,heartbeat
/dev/fakeUSB0,455,441,476,465,1837,3374569,34060,heartbeat
/dev/fakeUSB0,463,453,456,460,1832,3356224,34080,heartbeat
/dev/fakeUSB0,460,455,467,470,1852,3429904,34100,heartbeat
/dev/fakeUSB0,464,452,469,477,1862,3467044,34120,heartbeat
/dev/fakeUSB0,473,468,467,482,1890,3572100,34140,heartbeat
/dev/fakeUSB0,462,466,462,468,1858,3452164,34160,heartbeat
/dev/fakeUSB0,461,458,470,452,1841,3389281,34180,heartbeat
/dev/fakeUSB0,433,445,465,461,1804,3254416,34200,heartbeat
/dev/fakeUSB0,425,444,451,461,1781,3171961,34220,heartbeat
/dev/fakeUSB0,431,461,476,454,1822,3319684,34240,heartbeat
/dev/fakeUSB0,425,445,444,447,1761,3101121,34260,heartbeat
/dev/fakeUSB0,415,432,452,468,1767,3122289,34280,heartbeat
/dev/fakeUSB0,429,444,468,454,1795,3222025,34300,heartbeat
/dev/fakeUSB0,432,443,475,459,1809,3272481,34320,heartbeat
/dev/fakeUSB0,430,439,475,450,1794,3218436,34340,heartbeat
/dev/fakeUSB0,412,436,457,465,1770,3132900,34360,heartbeat
/dev/fakeUSB0,413,442,446,462,1763,3108169,34380,heartbeat
/dev/fakeUSB0,421,435,464,468,1788,3196944,34400,heartbeat
/dev/fakeUSB0,413,436,469,453,1771,3136441,34420,heartbeat
/dev/fakeUSB0,417,436,461,460,1774,3147076,34440,heartbeat
/dev/fakeUSB0,430,452,456,465,1803,3250809,34460,heartbeat
/dev/fakeUSB0,441,453,469,451,1814,3290596,34480,heartbeat
/dev/fakeUSB0,480,481,464,465,1890,3572100,34500,heartbeat
/dev/fakeUSB0,520,501,483,477,1981,3924361,34520,heartbeat
/dev/fakeUSB0,553,524,503,485,2065,4264225,34540,heartbeat
/dev/fakeUSB0,570,523,483,487,2063,4255969,34560,heartbeat
/dev/fakeUSB0,556,514,496,492,2058,4235364,34580,heartbeat
/dev/fakeUSB0,524,511,488,494,2017,4068289,34600,heartbeat
/dev/fakeUSB0,504,492,480,483,1959,3837681,34620,heartbeat
/dev/fakeUSB0,487,458,488,467,1900,3610000,34640,heartbeat
/dev/fakeUSB0,464,455,470,484,1873,3508129,34660,heartbeat
/dev/fakeUSB0,452,456,471,478,1857,3448449,34680,heartbeat
/dev/fakeUSB0,440,448,463,465,1816,3297856,34700,heartbeat
/dev/fakeUSB0,437,444,460,462,1803,3250809,34720,heartbeat
/dev/fakeUSB0,440,453,464,460,1817,3301489,34740,heartbeat
/dev/fakeUSB0,439,453,468,471,1831,3352561,34760,heartbeat
/dev/fakeUSB0,456,455,455,474,1840,3385600,34780,heartbeat
/dev/fakeUSB0,459,452,472,468,1851,3426201,34800,heartbeat
/dev/fakeUSB0,459,467,463,462,1851,3426201,34820,heartbeat
/dev/fakeUSB0,457,469,465,468,1859,3455881,34840,heartbeat
/dev/fakeUSB0,460,454,473,454,1841,3389281,34860,heartbeat
/dev/fakeUSB0,432,460,466,463,1821,3316041,34880,heartbeat
/dev/fakeUSB0,436,451,467,451,1805,3258025,34900,heartbeat
/dev/fakeUSB0,441,449,466,455,1811,3279721,34920,heartbeat
/dev/fakeUSB0,429,435,437,451,1752,3069504,34940,heartbeat
/dev/fakeUSB0,420,431,447,452,1750,3062500,34960,heartbeat
/dev/fakeUSB0,412,435,458,453,1758,3090564,34980,heartbeat
/dev/fakeUSB0,424,436,468,448,1776,3154176,35000,heartbeat
/dev/fakeUSB0,428,438,460,458,1784,3182656,35020,heartbeat
/dev/fakeUSB0,430,443,452,455,1780,3168400,35040,heartbeat
/dev/fakeUSB0,439,437,467,449,1792,3211264,35060,heartbeat
/dev/fakeUSB0,441,448,444,452,1785,3186225,35080,heartbeat
/dev/fakeUSB0,440,441,451,467,1799,3236401,35100,heartbeat
/dev/fakeUSB0,436,451,456,453,1796,3225616,35120,heartbeat
/dev/fakeUSB0,458,452,455,473,1838,3378244,35140,heartbeat
/dev/fakeUSB0,482,471,474,475,1902,3617604,35160,heartbeat
/dev/fakeUSB0,521,473,472,493,1959,3837681,35180,heartbeat
/dev/fakeUSB0,574,505,487,491,2057,4231249,35200,heartbeat
/dev/fakeUSB0,611,515,502,497,2125,4515625,35220,heartbeat
/dev/fakeUSB0,624,517,505,476,2122,4502884,35240,heartbeat
/dev/fakeUSB0,596,508,496,479,2079,4322241,35260,heartbeat
/dev/fakeUSB0,571,514,483,482,2050,4202500,35280,heartbeat
/dev/fakeUSB0,556,491,491,460,1998,3992004,35300,heartbeat
/dev/fakeUSB0,539,473,475,456,1943,3775249,35320,heartbeat
/dev/fakeUSB0,511,461,470,445,1887,3560769,35340,heartbeat
/dev/fakeUSB0,484,450,456,448,1838,3378244,35360,heartbeat
/dev/fakeUSB0,480,450,472,469,1871,3500641,35380,heartbeat
/dev/fakeUSB0,472,451,463,449,1835,3367225,35400,heartbeat
/dev/fakeUSB0,479,452,468,464,1863,3470769,35420,heartbeat
/dev/fakeUSB0,476,457,461,463,1857,3448449,35440,heartbeat
/dev/fakeUSB0,493,463,480,476,1912,3655744,35460,heartbeat
/dev/fakeUSB0,489,468,478,463,1898,3602404,35480,heartbeat
/dev/fakeUSB0,494,466,460,463,1883,3545689,35500,heartbeat
/dev/fakeUSB0,476,474,469,456,1875,3515625,35520,heartbeat
/dev/fakeUSB0,478,465,475,459,1877,3523129,35540,heartbeat
/dev/fakeUSB0,460,446,465,453,1824,3326976,35560,heartbeat
/dev/fakeUSB0,457,448,454,440,1799,3236401,35580,heartbeat
/dev/fakeUSB0,447,438,462,468,1815,3294225,35600,heartbeat
/dev/fakeUSB0,449,444,466,449,1808,3268864,35620,heartbeat
/dev/fakeUSB0,452,441,454,460,1807,3265249,35640,heartbeat
/dev/fakeUSB0,445,449,463,468,1825,3330625,35660,heartbeat
/dev/fakeUSB0,440,451,451,450,1792,3211264,35680,heartbeat
/dev/fakeUSB0,432,449,449,463,1793,3214849,35700,heartbeat
/dev/fakeUSB0,441,446,452,444,1783,3179089,35720,heartbeat
/dev/fakeUSB0,437,444,451,459,1791,3207681,35740,heartbeat
/dev/fakeUSB0,440,457,447,462,1806,3261636,35760,heartbeat
/dev/fakeUSB0,429,444,464,446,1783,3179089,35780,heartbeat
/dev/fakeUSB0,443,449,446,438,1776,3154176,35800,heartbeat
/dev/fakeUSB0,454,442,464,454,1814,3290596,35820,heartbeat
/dev/fakeUSB0,481,457,467,463,1868,3489424,35840,heartbeat
/dev/fakeUSB0,528,492,479,468,1967,3869089,35860,heartbeat
/dev/fakeUSB0,568,487,478,488,2021,4084441,35880,heartbeat
/dev/fakeUSB0,593,507,508,487,2095,4389025,35900,heartbeat
/dev/fakeUSB0,607,521,507,487,2122,4502884,35920,heartbeat
/dev/fakeUSB0,582,509,484,475,2050,4202500,35940,heartbeat
/dev/fakeUSB0,564,511,484,463,2022,4088484,35960,heartbeat
/dev/fakeUSB0,524,494,481,476,1975,3900625,35980,heartbeat
/dev/fakeUSB0,521,487,486,463,1957,3829849,36000,heartbeat
/dev/fakeUSB0,510,456,455,464,1885,3553225,36020,heartbeat
/dev/fakeUSB0,471,450,469,464,1854,3437316,36040,heartbeat
/dev/fakeUSB0,477,452,466,465,1860,3459600,36060,heartbeat
/dev/fakeUSB0,481,452,474,446,1853,3433609,36080,heartbeat
/dev/fakeUSB0,473,442,445,460,1820,3312400,36100,heartbeat
/dev/fakeUSB0,475,455,474,445,1849,3418801,36120,heartbeat
/dev/fakeUSB0,479,454,473,471,1877,3523129,36140,heartbeat
/dev/fakeUSB0,460,472,467,460,1859,3455881,36160,heartbeat
/dev/fakeUSB0,458,461,475,466,1860,3459600,36180,heartbeat
/dev/fakeUSB0,461,456,477,465,1859,3455881,36200,heartbeat
/dev/fakeUSB0,471,462,467,457,1857,3448449,36220,heartbeat
/dev/fakeUSB0,455,460,468,468,1851,3426201,36240,heartbeat
/dev/fakeUSB0,444,445,470,460,1819,3308761,36260,heartbeat
/dev/fakeUSB0,436,441,458,456,1791,3207681,36280,heartbeat
/dev/fakeUSB0,447,443,445,452,1787,3193369,36300,heartbeat
/dev/fakeUSB0,419,437,454,454,1764,3111696,36320,heartbeat
/dev/fakeUSB0,426,437,436,452,1751,3066001,36340,heartbeat
/dev/fakeUSB0,430,432,466,443,1771,3136441,36360,heartbeat
/dev/fakeUSB0,443,459,459,465,1826,3334276,36380,heartbeat
/dev/fakeUSB0,440,444,461,461,1806,3261636,36400,heartbeat
/dev/fakeUSB0,451,441,469,463,1824,3326976,36420,heartbeat
/dev/fakeUSB0,438,444,452,453,1787,3193369,36440,heartbeat
/dev/fakeUSB0,436,435,448,461,1780,3168400,36460,heartbeat
/dev/fakeUSB0,427,432,453,448,1760,3097600,36480,heartbeat
/dev/fakeUSB0,442,431,448,458,1779,3164841,36500,heartbeat
/dev/fakeUSB0,467,458,461,466,1852,3429904,36520,heartbeat
/dev/fakeUSB0,508,476,462,466,1912,3655744,36540,heartbeat
/dev/fakeUSB0,544,491,466,476,1977,3908529,36560,heartbeat
/dev/fakeUSB0,556,498,497,475,2026,4104676,36580,heartbeat
/dev/fakeUSB0,572,520,492,492,2076,4309776,36600,heartbeat
/dev/fakeUSB0,571,511,498,501,2081,4330561,36620,heartbeat
/dev/fakeUSB0,538,508,500,477,2023,4092529,36640,heartbeat
/dev/fakeUSB0,522,499,495,464,1980,3920400,36660,heartbeat
/dev/fakeUSB0,501,478,488,488,1955,3822025,36680,heartbeat
/dev/fakeUSB0,487,457,480,468,1892,3579664,36700,heartbeat
/dev/fakeUSB0,474,460,473,456,1863,3470769,36720,heartbeat
/dev/fakeUSB0,452,459,480,450,1841,3389281,36740,heartbeat
/dev/fakeUSB0,446,439,468,464,1817,3301489,36760,heartbeat
/dev/fakeUSB0,460,431,466,471,1828,3341584,36780,heartbeat
/dev/fakeUSB0,450,435,458,459,1802,3247204,36800,heartbeat
/dev/fakeUSB0,448,448,460,463,1819,3308761,36820,heartbeat
/dev/fakeUSB0,464,461,461,475,1861,3463321,36840,heartbeat
/dev/fakeUSB0,460,461,470,461,1852,3429904,36860,heartbeat
/dev/fakeUSB0,443,471,469,469,1852,3429904,36880,heartbeat
/dev/fakeUSB0,455,458,464,460,1837,3374569,36900,heartbeat
/dev/fakeUSB0,449,456,443,458,1806,3261636,36920,heartbeat
/dev/fakeUSB0,444,455,460,463,1822,3319684,36940,heartbeat
/dev/fakeUSB0,425,435,463,446,1769,3129361,36960,heartbeat
/dev/fakeUSB0,428,447,447,449,1771,3136441,36980,heartbeat
/dev/fakeUSB0,412,440,473,452,1777,3157729,37000,heartbeat
/dev/fakeUSB0,408,430,464,457,1759,3094081,37020,heartbeat
/dev/fakeUSB0,392,436,451,459,1738,3020644,37040,heartbeat
/dev/fakeUSB0,406,440,448,452,1746,3048516,37060,heartbeat
/dev/fakeUSB0,399,447,449,459,1754,3076516,37080,heartbeat
/dev/fakeUSB0,403,445,449,455,1752,3069504,37100,heartbeat
/dev/fakeUSB0,388,436,454,450,1728,2985984,37120,heartbeat
/dev/fakeUSB0,400,446,439,465,1750,3062500,37140,heartbeat
/dev/fakeUSB0,393,440,449,449,1731,2996361,37160,heartbeat
/dev/fakeUSB0,397,427,451,453,1728,2985984,37180,heartbeat
/dev/fakeUSB0,424,448,452,461,1785,3186225,37200,heartbeat
/dev/fakeUSB0,442,459,454,464,1819,3308761,37220,heartbeat
/dev/fakeUSB0,479,475,480,481,1915,3667225,37240,heartbeat
/dev/fakeUSB0,511,500,478,482,1971,3884841,37260,heartbeat
/dev/fakeUSB0,539,527,505,499,2070,4284900,37280,heartbeat
/dev/fakeUSB0,534,522,485,486,2027,4108729,37300,heartbeat
/dev/fakeUSB0,527,506,509,481,2023,4092529,37320,heartbeat
/dev/fakeUSB0,508,492,494,465,1959,3837681,37340,heartbeat
/dev/fakeUSB0,490,491,467,461,1909,3644281,37360,heartbeat
/dev/fakeUSB0,471,469,480,469,1889,3568321,37380,heartbeat
/dev/fakeUSB0,455,455,475,471,1856,3444736,37400,heartbeat
/dev/fakeUSB0,450,463,451,446,1810,3276100,37420,heartbeat
/dev/fakeUSB0,436,456,457,453,1802,3247204,37440,heartbeat
/dev/fakeUSB0,430,462,466,467,1825,3330625,37460,heartbeat
/dev/fakeUSB0,432,469,469,459,1829,3345241,37480,heartbeat
/dev/fakeUSB0,432,474,451,468,1825,3330625,37500,heartbeat
/dev/fakeUSB0,451,464,467,475,1857,3448449,37520,heartbeat
/dev/fakeUSB0,455,461,449,460,1825,3330625,37540,heartbeat
/dev/fakeUSB0,455,459,468,472,1854,3437316,37560,heartbeat
/dev/fakeUSB0,454,464,468,464,1850,3422500,37580,heartbeat
/dev/fakeUSB0,460,466,464,476,1866,3481956,37600,heartbeat
/dev/fakeUSB0,431,452,468,473,1824,3326976,37620,heartbeat
/dev/fakeUSB0,426,451,455,459,1791,3207681,37640,heartbeat
/dev/fakeUSB0,429,447,455,461,1792,3211264,37660,heartbeat
/dev/fakeUSB0,426,437,463,468,1794,3218436,37680,heartbeat
/dev/fakeUSB0,423,446,449,462,1780,3168400,37700,heartbeat
/dev/fakeUSB0,428,444,452,459,1783,3179089,37720,heartbeat
/dev/fakeUSB0,420,454,440,466,1780,3168400,37740,heartbeat
/dev/fakeUSB0,412,451,452,467,1782,3175524,37760,heartbeat
/dev/fakeUSB0,425,451,455,448,1779,3164841,37780,heartbeat
/dev/fakeUSB0,426,452,438,436,1752,3069504,37800,heartbeat
/dev/fakeUSB0,422,452,453,448,1775,3150625,37820,heartbeat
/dev/fakeUSB0,425,451,468,464,1808,3268864,37840,heartbeat
/dev/fakeUSB0,432,459,464,453,1808,3268864,37860,heartbeat
/dev/fakeUSB0,454,461,455,473,1843,3396649,37880,heartbeat
/dev/fakeUSB0,468,484,464,498,1914,3663396,37900,heartbeat
/dev/fakeUSB0,496,492,482,492,1962,3849444,37920,heartbeat
/dev/fakeUSB0,535,507,494,498,2034,4137156,37940,heartbeat
/dev/fakeUSB0,552,535,507,504,2098,4401604,37960,heartbeat
/dev/fakeUSB0,562,532,507,509,2110,4452100,37980,heartbeat
/dev/fakeUSB0,551,544,501,504,2100,4410000,38000,heartbeat
/dev/fakeUSB0,552,513,494,483,2042,4169764,38020,heartbeat
/dev/fakeUSB0,540,506,486,488,2020,4080400,38040,heartbeat
/dev/fakeUSB0,517,489,481,484,1971,3884841,38060,heartbeat
/dev/fakeUSB0,507,486,477,484,1954,3818116,38080,heartbeat
/dev/fakeUSB0,488,477,459,466,1890,3572100,38100,heartbeat
/dev/fakeUSB0,484,470,464,474,1892,3579664,38120,heartbeat
/dev/fakeUSB0,481,471,476,490,1918,3678724,38140,heartbeat
/dev/fakeUSB0,480,459,454,485,1878,3526884,38160,heartbeat
/dev/fakeUSB0,488,464,465,483,1900,3610000,38180,heartbeat
/dev/fakeUSB0,477,459,471,482,1889,3568321,38200,heartbeat
/dev/fakeUSB0,485,471,468,484,1908,3640464,38220,heartbeat
/dev/fakeUSB0,484,476,475,469,1904,3625216,38240,heartbeat
/dev/fakeUSB0,476,472,465,482,1895,3591025,38260,heartbeat
/dev/fakeUSB0,482,469,476,481,1908,3640464,38280,heartbeat
/dev/fakeUSB0,482,461,467,453,1863,3470769,38300,heartbeat
/dev/fakeUSB0,476,456,458,446,1836,3370896,38320,heartbeat
/dev/fakeUSB0,475,460,465,439,1839,3381921,38340,heartbeat
/dev/fakeUSB0,483,477,460,446,1866,3481956,38360,heartbeat
/dev/fakeUSB0,472,472,469,428,1841,3389281,38380,heartbeat
/dev/fakeUSB0,460,469,460,438,1827,3337929,38400,heartbeat
/dev/fakeUSB0,468,451,459,430,1808,3268864,38420,heartbeat
/dev/fakeUSB0,458,453,464,444,1819,3308761,38440,heartbeat
/dev/fakeUSB0,457,444,464,453,1818,3305124,38460,heartbeat
/dev/fakeUSB0,444,445,436,432,1757,3087049,38480,heartbeat
/dev/fakeUSB0,449,448,460,433,1790,3204100,38500,heartbeat
/dev/fakeUSB0,452,436,444,439,1771,3136441,38520,heartbeat
/dev/fakeUSB0,473,449,439,436,1797,3229209,38540,heartbeat
/dev/fakeUSB0,472,457,456,445,1830,3348900,38560,heartbeat
/dev/fakeUSB0,495,465,459,468,1887,3560769,38580,heartbeat
/dev/fakeUSB0,518,500,481,484,1983,3932289,38600,heartbeat
/dev/fakeUSB0,574,516,478,481,2049,4198401,38620,heartbeat
/dev/fakeUSB0,595,542,492,473,2102,4418404,38640,heartbeat
/dev/fakeUSB0,593,527,516,490,2126,4519876,38660,heartbeat
/dev/fakeUSB0,604,539,500,487,2130,4536900,38680,heartbeat
/dev/fakeUSB0,595,521,482,454,2052,4210704,38700,heartbeat
/dev/fakeUSB0,571,520,481,447,2019,4076361,38720,heartbeat
/dev/fakeUSB0,578,505,482,445,2010,4040100,38740,heartbeat
/dev/fakeUSB0,573,491,457,445,1966,3865156,38760,heartbeat
/dev/fakeUSB0,567,485,453,436,1941,3767481,38780,heartbeat
/dev/fakeUSB0,557,479,460,428,1924,3701776,38800,heartbeat
/dev/fakeUSB0,564,490,443,420,1917,3674889,38820,heartbeat
/dev/fakeUSB0,546,482,463,418,1909,3644281,38840,heartbeat
/dev/fakeUSB0,536,477,441,428,1882,3541924,38860,heartbeat
/dev/fakeUSB0,540,468,456,421,1885,3553225,38880,heartbeat
/dev/fakeUSB0,551,490,480,448,1969,3876961,38900,heartbeat
/dev/fakeUSB0,533,480,468,456,1937,3751969,38920,heartbeat
/dev/fakeUSB0,527,463,456,460,1906,3632836,38940,heartbeat
/dev/fakeUSB0,523,468,457,473,1921,3690241,38960,heartbeat
/dev/fakeUSB0,516,471,452,459,1898,3602404,38980,heartbeat
/dev/fakeUSB0,510,473,453,442,1878,3526884,39000,heartbeat
/dev/fakeUSB0,519,455,452,447,1873,3508129,39020,heartbeat
/dev/fakeUSB0,532,461,459,457,1909,3644281,39040,heartbeat
/dev/fakeUSB0,527,476,460,446,1909,3644281,39060,heartbeat
/dev/fakeUSB0,540,468,458,449,1915,3667225,39080,heartbeat
/dev/fakeUSB0,553,461,460,446,1920,3686400,39100,heartbeat
/dev/fakeUSB0,554,468,453,433,1908,3640464,39120,heartbeat
/dev/fakeUSB0,568,456,448,450,1922,3694084,39140,heartbeat
/dev/fakeUSB0,541,462,447,445,1895,3591025,39160,heartbeat
/dev/fakeUSB0,524,457,436,426,1843,3396649,39180,heartbeat
/dev/fakeUSB0,517,456,458,444,1875,3515625,39200,heartbeat
/dev/fakeUSB0,511,446,454,453,1864,3474496,39220,heartbeat
/dev/fakeUSB0,501,458,460,437,1856,3444736,39240,heartbeat
/dev/fakeUSB0,516,475,470,457,1918,3678724,39260,heartbeat
/dev/fakeUSB0,575,503,472,464,2014,4056196,39280,heartbeat
/dev/fakeUSB0,624,544,476,484,2128,4528384,39300,heartbeat
/dev/fakeUSB0,649,557,508,496,2210,4884100,39320,heartbeat
/dev/fakeUSB0,663,581,488,488,2220,4928400,39340,heartbeat
/dev/fakeUSB0,669,578,497,492,2236,4999696,39360,heartbeat
/dev/fakeUSB0,664,564,484,468,2180,4752400,39380,heartbeat
/dev/fakeUSB0,631,548,481,466,2126,4519876,39400,heartbeat
/dev/fakeUSB0,599,540,473,457,2069,4280761,39420,heartbeat
/dev/fakeUSB0,601,523,476,457,2057,4231249,39440,heartbeat
/dev/fakeUSB0,583,514,481,453,2031,4124961,39460,heartbeat
/dev/fakeUSB0,563,515,467,452,1997,3988009,39480,heartbeat
/dev/fakeUSB0,548,504,478,463,1993,3972049,39500,heartbeat
/dev/fakeUSB0,532,504,473,449,1958,3833764,39520,heartbeat
/dev/fakeUSB0,526,479,461,466,1932,3732624,39540,heartbeat
/dev/fakeUSB0,515,482,458,474,1929,3721041,39560,heartbeat
/dev/fakeUSB0,510,468,476,484,1938,3755844,39580,heartbeat
/dev/fakeUSB0,500,472,477,479,1928,3717184,39600,heartbeat
/dev/fakeUSB0,488,471,468,456,1883,3545689,39620,heartbeat
/dev/fakeUSB0,498,461,460,452,1871,3500641,39640,heartbeat
/dev/fakeUSB0,483,457,473,458,1871,3500641,39660,heartbeat
/dev/fakeUSB0,469,456,460,458,1843,3396649,39680,heartbeat
/dev/fakeUSB0,458,444,445,448,1795,3222025,39700,heartbeat
/dev/fakeUSB0,442,458,446,458,1804,3254416,39720,heartbeat
/dev/fakeUSB0,444,441,451,455,1791,3207681,39740,heartbeat
/dev/fakeUSB0,420,449,458,444,1771,3136441,39760,heartbeat
/dev/fakeUSB0,433,444,444,457,1778,3161284,39780,heartbeat
/dev/fakeUSB0,428,448,435,462,1773,3143529,39800,heartbeat
/dev/fakeUSB0,437,437,456,444,1774,3147076,39820,heartbeat
/dev/fakeUSB0,436,436,456,450,1778,3161284,39840,heartbeat
/dev/fakeUSB0,414,429,450,450,1743,3038049,39860,heartbeat
/dev/fakeUSB0,414,427,457,443,1741,3031081,39880,heartbeat
/dev/fakeUSB0,410,428,442,441,1721,2961841,39900,heartbeat
/dev/fakeUSB0,422,429,440,460,1751,3066001,39920,heartbeat
/dev/fakeUSB0,444,441,465,455,1805,3258025,39940,heartbeat
/dev/fakeUSB0,480,488,463,468,1899,3606201,39960,heartbeat
/dev/fakeUSB0,528,511,481,484,2004,4016016,39980,heartbeat
/dev/fakeUSB0,551,535,482,491,2059,4239481,40000,heartbeat
/dev/fakeUSB0,575,533,495,479,2082,4334724,40020,heartbeat
/dev/fakeUSB0,573,531,511,479,2094,4384836,40040,heartbeat
/dev/fakeUSB0,561,521,492,481,2055,4223025,40060,heartbeat
/dev/fakeUSB0,533,511,488,464,1996,3984016,40080,heartbeat
/dev/fakeUSB0,500,484,475,474,1933,3736489,40100,heartbeat
/dev/fakeUSB0,481,475,459,457,1872,3504384,40120,heartbeat
/dev/fakeUSB0,474,463,468,459,1864,3474496,40140,heartbeat
/dev/fakeUSB0,466,463,453,455,1837,3374569,40160,heartbeat
/dev/fakeUSB0,443,435,456,455,1789,3200521,40180,heartbeat
/dev/fakeUSB0,455,447,460,473,1835,3367225,40200,heartbeat
/dev/fakeUSB0,448,437,473,468,1826,3334276,40220,heartbeat
/dev/fakeUSB0,466,455,455,470,1846,3407716,40240,heartbeat
/dev/fakeUSB0,460,449,465,453,1827,3337929,40260,heartbeat
/dev/fakeUSB0,457,456,474,479,1866,3481956,40280,heartbeat
/dev/fakeUSB0,450,464,468,476,1858,3452164,40300,heartbeat
/dev/fakeUSB0,447,449,462,463,1821,3316041,40320,heartbeat
/dev/fakeUSB0,430,434,459,452,1775,3150625,40340,heartbeat
/dev/fakeUSB0,421,432,471,452,1776,3154176,40360,heartbeat
/dev/fakeUSB0,417,428,476,461,1782,3175524,40380,heartbeat
/dev/fakeUSB0,404,428,441,447,1720,2958400,40400,heartbeat
/dev/fakeUSB0,404,420,448,441,1713,2934369,40420,heartbeat
/dev/fakeUSB0,402,432,466,448,1748,3055504,40440,heartbeat
/dev/fakeUSB0,432,430,471,446,1779,3164841,40460,heartbeat
/dev/fakeUSB0,419,436,460,438,1753,3073009,40480,heartbeat
/dev/fakeUSB0,424,444,459,436,1763,3108169,40500,heartbeat
/dev/fakeUSB0,415,434,447,454,1750,3062500,40520,heartbeat
/dev/fakeUSB0,425,433,464,441,1763,3108169,40540,heartbeat
/dev/fakeUSB0,420,437,449,463,1769,3129361,40560,heartbeat
/dev/fakeUSB0,421,424,461,455,1761,3101121,40580,heartbeat
/dev/fakeUSB0,432,432,472,442,1778,3161284,40600,heartbeat
/dev/fakeUSB0,445,451,459,462,1817,3301489,40620,heartbeat
/dev/fakeUSB0,479,461,460,459,1859,3455881,40640,heartbeat
/dev/fakeUSB0,519,494,479,469,1961,3845521,40660,heartbeat
/dev/fakeUSB0,550,520,493,497,2060,4243600,40680,heartbeat
/dev/fakeUSB0,571,519,508,481,2079,4322241,40700,heartbeat
/dev/fakeUSB0,572,519,498,475,2064,4260096,40720,heartbeat
/dev/fakeUSB0,554,500,500,492,2046,4186116,40740,heartbeat
/dev/fakeUSB0,539,500,480,470,1989,3956121,40760,heartbeat
/dev/fakeUSB0,516,479,479,454,1928,3717184,40780,heartbeat
/dev/fakeUSB0,488,458,473,453,1872,3504384,40800,heartbeat
/dev/fakeUSB0,474,450,463,454,1841,3389281,40820,heartbeat
/dev/fakeUSB0,460,458,460,452,1830,3348900,40840,heartbeat
/dev/fakeUSB0,457,445,454,453,1809,3272481,40860,heartbeat
/dev/fakeUSB0,460,455,462,452,1829,3345241,40880,heartbeat
/dev/fakeUSB0,465,451,461,449,1826,3334276,40900,heartbeat
/dev/fakeUSB0,482,456,457,460,1855,3441025,40920,heartbeat
/dev/fakeUSB0,484,451,473,444,1852,3429904,40940,heartbeat
/dev/fakeUSB0,479,449,452,449,1829,3345241,40960,heartbeat
/dev/fakeUSB0,476,455,468,470,1869,3493161,40980,heartbeat
/dev/fakeUSB0,480,449,485,465,1879,3530641,41000,heartbeat
/dev/fakeUSB0,452,456,459,447,1814,3290596,41020,heartbeat
/dev/fakeUSB0,437,457,477,451,1822,3319684,41040,heartbeat
/dev/fakeUSB0,446,443,444,436,1769,3129361,41060,heartbeat
/dev/fakeUSB0,444,428,457,452,1781,3171961,41080,heartbeat
/dev/fakeUSB0,429,419,471,451,1770,3132900,41100,heartbeat
/dev/fakeUSB0,429,417,456,443,1745,3045025,41120,heartbeat
/dev/fakeUSB0,439,434,456,454,1783,3179089,41140,heartbeat
/dev/fakeUSB0,447,443,445,459,1794,3218436,41160,heartbeat
/dev/fakeUSB0,427,432,458,445,1762,3104644,41180,heartbeat
/dev/fakeUSB0,436,434,463,447,1780,3168400,41200,heartbeat
/dev/fakeUSB0,434,434,447,464,1779,3164841,41220,heartbeat
/dev/fakeUSB0,425,429,462,453,1769,3129361,41240,heartbeat
/dev/fakeUSB0,429,438,452,453,1772,3139984,41260,heartbeat
/dev/fakeUSB0,442,429,456,447,1774,3147076,41280,heartbeat
/dev/fakeUSB0,469,468,472,463,1872,3504384,41300,heartbeat
/dev/fakeUSB0,494,468,463,457,1882,3541924,41320,heartbeat
/dev/fakeUSB0,544,479,485,480,1988,3952144,41340,heartbeat
/dev/fakeUSB0,563,510,498,481,2052,4210704,41360,heartbeat
/dev/fakeUSB0,563,511,498,482,2054,4218916,41380,heartbeat
/dev/fakeUSB0,556,508,501,460,2025,4100625,41400,heartbeat
/dev/fakeUSB0,551,499,488,468,2006,4024036,41420,heartbeat
/dev/fakeUSB0,519,492,482,470,1963,3853369,41440,heartbeat
/dev/fakeUSB0,500,474,482,472,1928,3717184,41460,heartbeat
/dev/fakeUSB0,482,457,468,435,1842,3392964,41480,heartbeat
/dev/fakeUSB0,472,448,468,455,1843,3396649,41500,heartbeat
/dev/fakeUSB0,468,444,468,452,1832,3356224,41520,heartbeat
/dev/fakeUSB0,460,440,459,455,1814,3290596,41540,heartbeat
/dev/fakeUSB0,446,434,468,444,1792,3211264,41560,heartbeat
/dev/fakeUSB0,466,444,460,466,1836,3370896,41580,heartbeat
/dev/fakeUSB0,460,450,478,456,1844,3400336,41600,heartbeat
/dev/fakeUSB0,468,454,480,450,1852,3429904,41620,heartbeat
/dev/fakeUSB0,451,428,468,440,1787,3193369,41640,heartbeat
/dev/fakeUSB0,464,436,482,444,1826,3334276,41660,heartbeat
/dev/fakeUSB0,449,444,477,443,1813,3286969,41680,heartbeat
/dev/fakeUSB0,443,445,468,444,1800,3240000,41700,heartbeat
/dev/fakeUSB0,427,443,447,436,1753,3073009,41720,heartbeat
/dev/fakeUSB0,434,444,471,441,1790,3204100,41740,heartbeat
/dev/fakeUSB0,432,432,457,444,1765,3115225,41760,heartbeat
/dev/fakeUSB0,425,430,456,440,1751,3066001,41780,heartbeat
/dev/fakeUSB0,428,438,460,437,1763,3108169,41800,heartbeat
/dev/fakeUSB0,428,427,454,458,1767,3122289,41820,heartbeat
/dev/fakeUSB0,419,434,460,431,1744,3041536,41840,heartbeat
/dev/fakeUSB0,429,437,445,437,1748,3055504,41860,heartbeat
/dev/fakeUSB0,423,449,454,454,1780,3168400,41880,heartbeat
/dev/fakeUSB0,428,446,435,451,1760,3097600,41900,heartbeat
/dev/fakeUSB0,431,446,462,451,1790,3204100,41920,heartbeat
/dev/fakeUSB0,419,433,462,439,1753,3073009,41940,heartbeat
/dev/fakeUSB0,438,445,449,446,1778,3161284,41960,heartbeat
/dev/fakeUSB0,455,471,472,460,1858,3452164,41980,heartbeat
/dev/fakeUSB0,482,485,482,482,1931,3728761,42000,heartbeat
/dev/fakeUSB0,497,504,493,488,1982,3928324,42020,heartbeat
/dev/fakeUSB0,498,493,491,476,1958,3833764,42040,heartbeat
/dev/fakeUSB0,527,521,511,489,2048,4194304,42060,heartbeat
/dev/fakeUSB0,511,516,480,460,1967,3869089,42080,heartbeat
/dev/fakeUSB0,502,496,496,459,1953,3814209,42100,heartbeat
/dev/fakeUSB0,479,491,492,454,1916,3671056,42120,heartbeat
/dev/fakeUSB0,469,472,473,444,1858,3452164,42140,heartbeat
/dev/fakeUSB0,455,455,487,444,1841,3389281,42160,heartbeat
/dev/fakeUSB0,430,445,465,444,1784,3182656,42180,heartbeat
/dev/fakeUSB0,449,436,475,432,1792,3211264,42200,heartbeat
/dev/fakeUSB0,452,440,471,445,1808,3268864,42220,heartbeat
/dev/fakeUSB0,440,442,468,452,1802,3247204,42240,heartbeat
/dev/fakeUSB0,434,444,455,456,1789,3200521,42260,heartbeat
/dev/fakeUSB0,433,459,479,457,1828,3341584,42280,heartbeat
/dev/fakeUSB0,452,437,463,458,1810,3276100,42300,heartbeat
/dev/fakeUSB0,428,453,460,438,1779,3164841,42320,heartbeat
/dev/fakeUSB0,432,454,456,451,1793,3214849,42340,heartbeat
/dev/fakeUSB0,428,455,462,454,1799,3236401,42360,heartbeat
/dev/fakeUSB0,410,446,466,437,1759,3094081,42380,heartbeat
/dev/fakeUSB0,406,433,470,448,1757,3087049,42400,heartbeat
/dev/fakeUSB0,397,437,469,451,1754,3076516,42420,heartbeat
/dev/fakeUSB0,403,443,461,439,1746,3048516,42440,heartbeat
/dev/fakeUSB0,383,436,462,438,1719,2954961,42460,heartbeat
/dev/fakeUSB0,392,432,452,432,1708,2917264,42480,heartbeat
/dev/fakeUSB0,393,431,460,445,1729,2989441,42500,heartbeat
/dev/fakeUSB0,380,441,453,452,1726,2979076,42520,heartbeat
/dev/fakeUSB0,396,451,461,452,1760,3097600,42540,heartbeat
/dev/fakeUSB0,405,428,457,427,1717,2948089,42560,heartbeat
/dev/fakeUSB0,395,449,446,444,1734,3006756,42580,heartbeat
/dev/fakeUSB0,410,430,468,450,1758,3090564,42600,heartbeat
/dev/fakeUSB0,400,437,458,453,1748,3055504,42620,heartbeat
/dev/fakeUSB0,395,436,452,444,1727,2982529,42640,heartbeat
/dev/fakeUSB0,403,463,464,445,1775,3150625,42660,heartbeat
/dev/fakeUSB0,437,469,463,458,1827,3337929,42680,heartbeat
/dev/fakeUSB0,451,488,485,481,1905,3629025,42700,heartbeat
/dev/fakeUSB0,470,502,492,478,1942,3771364,42720,heartbeat
/dev/fakeUSB0,464,522,506,474,1966,3865156,42740,heartbeat
/dev/fakeUSB0,455,511,503,468,1937,3751969,42760,heartbeat
/dev/fakeUSB0,460,499,484,443,1886,3556996,42780,heartbeat
/dev/fakeUSB0,438,494,489,444,1865,3478225,42800,heartbeat
/dev/fakeUSB0,432,473,473,428,1806,3261636,42820,heartbeat
/dev/fakeUSB0,431,466,481,437,1815,3294225,42840,heartbeat
/dev/fakeUSB0,424,460,468,435,1787,3193369,42860,heartbeat
/dev/fakeUSB0,405,468,465,451,1789,3200521,42880,heartbeat
/dev/fakeUSB0,415,446,473,445,1779,3164841,42900,heartbeat
/dev/fakeUSB0,404,458,468,434,1764,3111696,42920,heartbeat
/dev/fakeUSB0,416,447,463,431,1757,3087049,42940,heartbeat
/dev/fakeUSB0,426,461,473,446,1806,3261636,42960,heartbeat
/dev/fakeUSB0,438,467,471,454,1830,3348900,42980,heartbeat
/dev/fakeUSB0,428,456,477,455,1816,3297856,43000,heartbeat
/dev/fakeUSB0,420,467,464,450,1801,3243601,43020,heartbeat
/dev/fakeUSB0,420,457,452,448,1777,3157729,43040,heartbeat
/dev/fakeUSB0,408,452,451,445,1756,3083536,43060,heartbeat
/dev/fakeUSB0,403,453,458,444,1758,3090564,43080,heartbeat
/dev/fakeUSB0,393,444,459,442,1738,3020644,43100,heartbeat
/dev/fakeUSB0,380,445,473,445,1743,3038049,43120,heartbeat
/dev/fakeUSB0,396,443,470,442,1751,3066001,43140,heartbeat
/dev/fakeUSB0,396,454,476,436,1762,3104644,43160,heartbeat
/dev/fakeUSB0,400,458,456,458,1772,3139984,43180,heartbeat
/dev/fakeUSB0,401,449,455,454,1759,3094081,43200,heartbeat
/dev/fakeUSB0,403,450,468,443,1764,3111696,43220,heartbeat
/dev/fakeUSB0,402,443,448,447,1740,3027600,43240,heartbeat
/dev/fakeUSB0,400,443,442,434,1719,2954961,43260,heartbeat
/dev/fakeUSB0,412,450,455,451,1768,3125824,43280,heartbeat
/dev/fakeUSB0,429,450,447,464,1790,3204100,43300,heartbeat
/dev/fakeUSB0,424,456,468,459,1807,3265249,43320,heartbeat
/dev/fakeUSB0,436,468,470,472,1846,3407716,43340,heartbeat
/dev/fakeUSB0,472,486,469,491,1918,3678724,43360,heartbeat
/dev/fakeUSB0,478,499,498,489,1964,3857296,43380,heartbeat
/dev/fakeUSB0,465,524,496,481,1966,3865156,43400,heartbeat
/dev/fakeUSB0,478,524,517,486,2005,4020025,43420,heartbeat
/dev/fakeUSB0,468,508,505,491,1972,3888784,43440,heartbeat
/dev/fakeUSB0,472,487,504,467,1930,3724900,43460,heartbeat
/dev/fakeUSB0,465,500,496,470,1931,3728761,43480,heartbeat
/dev/fakeUSB0,455,493,482,455,1885,3553225,43500,heartbeat
/dev/fakeUSB0,444,475,485,472,1876,3519376,43520,heartbeat
/dev/fakeUSB0,441,468,472,457,1838,3378244,43540,heartbeat
/dev/fakeUSB0,427,461,478,452,1818,3305124,43560,heartbeat
/dev/fakeUSB0,445,471,462,460,1838,3378244,43580,heartbeat
/dev/fakeUSB0,455,473,461,461,1850,3422500,43600,heartbeat
/dev/fakeUSB0,453,459,478,452,1842,3392964,43620,heartbeat
/dev/fakeUSB0,452,464,475,458,1849,3418801,43640,heartbeat
/dev/fakeUSB0,460,457,472,467,1856,3444736,43660,heartbeat
/dev/fakeUSB0,449,455,484,479,1867,3485689,43680,heartbeat
/dev/fakeUSB0,460,462,452,468,1842,3392964,43700,heartbeat
/dev/fakeUSB0,460,463,445,468,1836,3370896,43720,heartbeat
/dev/fakeUSB0,458,468,462,458,1846,3407716,43740,heartbeat
/dev/fakeUSB0,459,460,463,463,1845,3404025,43760,heartbeat
/dev/fakeUSB0,467,449,462,436,1814,3290596,43780,heartbeat
/dev/fakeUSB0,450,444,460,464,1818,3305124,43800,heartbeat
/dev/fakeUSB0,456,445,450,459,1810,3276100,43820,heartbeat
/dev/fakeUSB0,467,450,453,455,1825,3330625,43840,heartbeat
/dev/fakeUSB0,460,452,444,456,1812,3283344,43860,heartbeat
/dev/fakeUSB0,455,449,452,453,1809,3272481,43880,heartbeat
/dev/fakeUSB0,444,452,446,447,1789,3200521,43900,heartbeat
/dev/fakeUSB0,464,453,440,460,1817,3301489,43920,heartbeat
/dev/fakeUSB0,455,447,453,445,1800,3240000,43940,heartbeat
/dev/fakeUSB0,444,445,456,452,1797,3229209,43960,heartbeat
/dev/fakeUSB0,450,458,453,463,1824,3326976,43980,heartbeat
/dev/fakeUSB0,458,470,453,457,1838,3378244,44000,heartbeat
/dev/fakeUSB0,478,492,486,480,1936,3748096,44020,heartbeat
/dev/fakeUSB0,499,499,495,493,1986,3944196,44040,heartbeat
/dev/fakeUSB0,516,514,508,496,2034,4137156,44060,heartbeat
/dev/fakeUSB0,523,536,507,484,2050,4202500,44080,heartbeat
/dev/fakeUSB0,508,537,501,492,2038,4153444,44100,heartbeat
/dev/fakeUSB0,517,523,517,494,2051,4206601,44120,heartbeat
/dev/fakeUSB0,515,518,489,474,1996,3984016,44140,heartbeat
/dev/fakeUSB0,484,502,476,459,1921,3690241,44160,heartbeat
/dev/fakeUSB0,484,484,485,464,1917,3674889,44180,heartbeat
/dev/fakeUSB0,469,469,479,454,1871,3500641,44200,heartbeat
/dev/fakeUSB0,469,473,465,452,1859,3455881,44220,heartbeat
/dev/fakeUSB0,467,465,466,460,1858,3452164,44240,heartbeat
/dev/fakeUSB0,458,463,452,462,1835,3367225,44260,heartbeat
/dev/fakeUSB0,473,468,455,447,1843,3396649,44280,heartbeat
/dev/fakeUSB0,478,459,468,471,1876,3519376,44300,heartbeat
/dev/fakeUSB0,476,460,462,471,1869,3493161,44320,heartbeat
/dev/fakeUSB0,476,469,451,456,1852,3429904,44340,heartbeat
/dev/fakeUSB0,490,473,462,463,1888,3564544,44360,heartbeat
/dev/fakeUSB0,475,453,476,477,1881,3538161,44380,heartbeat
/dev/fakeUSB0,456,463,452,460,1831,3352561,44400,heartbeat
/dev/fakeUSB0,453,451,460,465,1829,3345241,44420,heartbeat
/dev/fakeUSB0,444,463,449,473,1829,3345241,44440,heartbeat
/dev/fakeUSB0,454,458,459,450,1821,3316041,44460,heartbeat
/dev/fakeUSB0,444,451,459,444,1798,3232804,44480,heartbeat
/dev/fakeUSB0,459,448,448,447,1802,3247204,44500,heartbeat
/dev/fakeUSB0,462,448,452,444,1806,3261636,44520,heartbeat
/dev/fakeUSB0,466,460,449,451,1826,3334276,44540,heartbeat
/dev/fakeUSB0,448,460,436,460,1804,3254416,44560,heartbeat
/dev/fakeUSB0,457,442,461,445,1805,3258025,44580,heartbeat
/dev/fakeUSB0,461,452,453,448,1814,3290596,44600,heartbeat
/dev/fakeUSB0,453,439,442,457,1791,3207681,44620,heartbeat
/dev/fakeUSB0,464,450,447,451,1812,3283344,44640,heartbeat
/dev/fakeUSB0,484,460,452,470,1866,3481956,44660,heartbeat
/dev/fakeUSB0,521,465,465,473,1924,3701776,44680,heartbeat
/dev/fakeUSB0,532,498,493,476,1999,3996001,44700,heartbeat
/dev/fakeUSB0,555,525,488,502,2070,4284900,44720,heartbeat
/dev/fakeUSB0,575,547,516,500,2138,4571044,44740,heartbeat
/dev/fakeUSB0,575,539,505,508,2127,4524129,44760,heartbeat
/dev/fakeUSB0,565,529,523,490,2107,4439449,44780,heartbeat
/dev/fakeUSB0,565,507,521,493,2086,4351396,44800,heartbeat
/dev/fakeUSB0,544,505,493,484,2026,4104676,44820,heartbeat
/dev/fakeUSB0,536,499,479,482,1996,3984016,44840,heartbeat
/dev/fakeUSB0,518,492,471,471,1952,3810304,44860,heartbeat
/dev/fakeUSB0,524,475,467,476,1942,3771364,44880,heartbeat
/dev/fakeUSB0,514,475,472,469,1930,3724900,44900,heartbeat
/dev/fakeUSB0,491,469,449,474,1883,3545689,44920,heartbeat
/dev/fakeUSB0,501,468,442,475,1886,3556996,44940,heartbeat
/dev/fakeUSB0,494,486,463,464,1907,3636649,44960,heartbeat
/dev/fakeUSB0,495,487,451,479,1912,3655744,44980,heartbeat
/dev/fakeUSB0,508,473,461,482,1924,3701776,45000,heartbeat
/dev/fakeUSB0,510,489,461,478,1938,3755844,45020,heartbeat
/dev/fakeUSB0,508,481,458,478,1925,3705625,45040,heartbeat
/dev/fakeUSB0,516,471,460,488,1935,3744225,45060,heartbeat
/dev/fakeUSB0,518,460,456,464,1898,3602404,45080,heartbeat
/dev/fakeUSB0,499,452,465,472,1888,3564544,45100,heartbeat
/dev/fakeUSB0,487,471,455,488,1901,3613801,45120,heartbeat
/dev/fakeUSB0,477,463,431,467,1838,3378244,45140,heartbeat
/dev/fakeUSB0,467,456,433,460,1816,3297856,45160,heartbeat
/dev/fakeUSB0,456,459,441,467,1823,3323329,45180,heartbeat
/dev/fakeUSB0,468,456,435,474,1833,3359889,45200,heartbeat
/dev/fakeUSB0,480,451,445,461,1837,3374569,45220,heartbeat
/dev/fakeUSB0,465,447,432,461,1805,3258025,45240,heartbeat
/dev/fakeUSB0,481,452,443,468,1844,3400336,45260,heartbeat
/dev/fakeUSB0,466,468,441,473,1848,3415104,45280,heartbeat
/dev/fakeUSB0,462,446,443,472,1823,3323329,45300,heartbeat
/dev/fakeUSB0,465,452,441,471,1829,3345241,45320,heartbeat
/dev/fakeUSB0,462,472,437,464,1835,3367225,45340,heartbeat
/dev/fakeUSB0,470,481,457,473,1881,3538161,45360,heartbeat
/dev/fakeUSB0,505,499,454,472,1930,3724900,45380,heartbeat
/dev/fakeUSB0,521,526,482,519,2048,4194304,45400,heartbeat
/dev/fakeUSB0,530,522,498,509,2059,4239481,45420,heartbeat
/dev/fakeUSB0,544,552,500,530,2126,4519876,45440,heartbeat
/dev/fakeUSB0,535,534,495,498,2062,4251844,45460,heartbeat
/dev/fakeUSB0,522,538,500,489,2049,4198401,45480,heartbeat
/dev/fakeUSB0,519,525,486,498,2028,4112784,45500,heartbeat
/dev/fakeUSB0,516,500,473,479,1968,3873024,45520,heartbeat
/dev/fakeUSB0,483,487,457,468,1895,3591025,45540,heartbeat
/dev/fakeUSB0,459,485,460,455,1859,3455881,45560,heartbeat
/dev/fakeUSB0,454,484,463,453,1854,3437316,45580,heartbeat
/dev/fakeUSB0,445,475,444,460,1824,3326976,45600,heartbeat
/dev/fakeUSB0,447,484,458,459,1848,3415104,45620,heartbeat
/dev/fakeUSB0,465,500,459,461,1885,3553225,45640,heartbeat
/dev/fakeUSB0,477,546,447,451,1921,3690241,45660,heartbeat
/dev/fakeUSB0,491,582,447,449,1969,3876961,45680,heartbeat
/dev/fakeUSB0,503,609,437,436,1985,3940225,45700,heartbeat
/dev/fakeUSB0,516,622,455,462,2055,4223025,45720,heartbeat
/dev/fakeUSB0,540,611,462,460,2073,4297329,45740,heartbeat
/dev/fakeUSB0,565,591,446,434,2036,4145296,45760,heartbeat
/dev/fakeUSB0,595,577,435,404,2011,4044121,45780,heartbeat
/dev/fakeUSB0,635,547,458,374,2014,4056196,45800,heartbeat
/dev/fakeUSB0,657,541,456,334,1988,3952144,45820,heartbeat
/dev/fakeUSB0,670,524,447,339,1980,3920400,45840,heartbeat
/dev/fakeUSB0,667,522,466,327,1982,3928324,45860,heartbeat
/dev/fakeUSB0,662,525,452,345,1984,3936256,45880,heartbeat
/dev/fakeUSB0,662,529,444,334,1969,3876961,45900,heartbeat
/dev/fakeUSB0,647,554,457,314,1972,3888784,45920,heartbeat
/dev/fakeUSB0,620,574,452,304,1950,3802500,45940,heartbeat
/dev/fakeUSB0,615,611,447,304,1977,3908529,45960,heartbeat
/dev/fakeUSB0,605,633,464,343,2045,4182025,45980,heartbeat
/dev/fakeUSB0,617,669,520,258,2064,4260096,46000,heartbeat
/dev/fakeUSB0,595,804,631,145,2175,4730625,46020,setdown
/dev/fakeUSB0,475,251,801,0,1527,2331729,46040,setdown
/dev/fakeUSB0,492,1023,1023,0,2538,6441444,46060,setdown
/dev/fakeUSB0,1023,1007,1007,0,3037,9223369,46080,setdown
/dev/fakeUSB0,1009,1015,1007,0,3031,9186961,46100,setdown
/dev/fakeUSB0,1023,1015,621,662,3321,11029041,46120,setdown
/dev/fakeUSB0,1023,1023,1023,1000,4069,16556761,46140,setdown
/dev/fakeUSB0,1023,1023,1002,1009,4057,16459249,46160,setdown
/dev/fakeUSB0,1019,1014,1001,1023,4057,16459249,46180,setdown
/dev/fakeUSB0,1023,1023,1023,1023,4092,16744464,46200,setdown
/dev/fakeUSB0,1015,1022,1023,1023,4083,16670889,46220,setdown
/dev/fakeUSB0,991,1023,1007,1023,4044,16353936,46240,setdown
/dev/fakeUSB0,1023,996,1023,1023,4065,16524225,46260,setdown
/dev/fakeUSB0,1023,1023,1023,1023,4092,16744464,46280,setdown
/dev/fakeUSB0,1023,1019,1023,1023,4088,16711744,46300,setdown
/dev/fakeUSB0,1023,1016,1023,1023,4085,16687225,46320,setdown
/dev/fakeUSB0,1023,1023,1023,1023,4092,16744464,46340,setdown
/dev/fakeUSB0,1007,1023,1023,1023,4076,16613776,46360,setdown
/dev/fakeUSB0,1023,1023,1023,1023,4092,16744464,46380,setdown
/dev/fakeUSB0,1023,1023,1023,1018,4087,16703569,46400,setdown
/dev/fakeUSB0,1017,1023,1023,1007,4070,16564900,46420,setdown
/dev/fakeUSB0,1023,1023,1023,1023,4092,16744464,46440,setdown
/dev/fakeUSB0,1023,1023,1023,1009,4078,16630084,46460,setdown
/dev/fakeUSB0,1023,1023,1023,1023,4092,16744464,46480,setdown
/dev/fakeUSB0,1023,1023,1012,1023,4081,16654561,46500,setdown
/dev/fakeUSB0,1023,1023,1023,997,4066,16532356,46520,setdown
/dev/fakeUSB0,1023,1023,1016,995,4057,16459249,46540,setdown
/dev/fakeUSB0,1023,1023,1007,1023,4076,16613776,46560,setdown
/dev/fakeUSB0,1023,1023,1011,995,4052,16418704,46580,setdown
/dev/fakeUSB0,1023,1023,1012,989,4047,16378209,46600,setdown
/dev/fakeUSB0,1023,1023,1019,995,4060,16483600,46620,setdown
/dev/fakeUSB0,1023,1010,1023,999,4055,16443025,46640,setdown
/dev/fakeUSB0,1023,1023,1023,1012,4081,16654561,46660,setdown
/dev/fakeUSB0,1023,1001,1023,1011,4058,16467364,46680,setdown
/dev/fakeUSB0,1017,1023,1015,1023,4078,16630084,46700,setdown
/dev/fakeUSB0,1023,1023,1023,1023,4092,16744464,46720,setdown
/dev/fakeUSB0,1023,1023,1009,1023,4078,16630084,46740,setdown
/dev/fakeUSB0,1023,1007,1023,1023,4076,16613776,46760,setdown
/dev/fakeUSB0,1023,1021,1023,1023,4090,16728100,46780,setdown
/dev/fakeUSB0,1023,1023,1023,1023,4092,16744464,46800,setdown
/dev/fakeUSB0,997,1023,1023,1023,4066,16532356,46820,setdown
/dev/fakeUSB0,1023,1023,1023,1023,4092,16744464,46840,setdown
/dev/fakeUSB0,1023,1023,1023,1023,4092,16744464,46860,setdown
/dev/fakeUSB0,1001,1023,1023,1023,4070,16564900,46880,setdown
/dev/fakeUSB0,1023,1023,1023,1023,4092,16744464,46900,setdown
/dev/fakeUSB0,1023,1023,1023,1005,4074,16597476,46920,setdown
/dev/fakeUSB0,1023,1023,1023,1011,4080,16646400,46940,setdown
/dev/fakeUSB0,1023,1023,1023,1012,4081,16654561,46960,setdown
/dev/fakeUSB0,1023,1023,1022,1020,4088,16711744,46980,setdown
/dev/fakeUSB0,1023,1023,1023,1015,4084,16679056,47000,setdown
/dev/fakeUSB0,1023,1023,1023,997,4066,16532356,47020,setdown
/dev/fakeUSB0,1023,1023,1023,1023,4092,16744464,47040,setdown
/dev/fakeUSB0,1023,1023,1023,1020,4089,16719921,47060,setdown
/dev/fakeUSB0,1023,1023,1019,1023,4088,16711744,47080,setdown
/dev/fakeUSB0,1023,1013,1015,1021,4072,16581184,47100,setdown
/dev/fakeUSB0,1023,1011,1020,1023,4077,16621929,47120,setdown
/dev/fakeUSB0,1023,999,1023,1021,4066,16532356,47140,setdown
/dev/fakeUSB0,1023,1023,1023,1023,4092,16744464,47160,setdown
/dev/fakeUSB0,1023,1023,1013,1015,4074,16597476,47180,setdown
/dev/fakeUSB0,1019,1012,1023,1019,4073,16589329,47200,setdown
/dev/fakeUSB0,1020,1023,1023,1023,4089,16719921,47220,setdown
/dev/fakeUSB0,1023,996,1023,1013,4055,16443025,47240,setdown
/dev/fakeUSB0,1023,1023,1005,1017,4068,16548624,47260,setdown
/dev/fakeUSB0,1023,1009,1023,1023,4078,16630084,47280,setdown
/dev/fakeUSB0,1023,1023,1023,1023,4092,16744464,47300,setdown
/dev/fakeUSB0,999,1023,1023,1023,4068,16548624,47320,setdown
/dev/fakeUSB0,1023,1011,1023,1023,4080,16646400,47340,setdown
/dev/fakeUSB0,1023,1023,1023,1023,4092,16744464,47360,setdown
/dev/fakeUSB0,1023,1023,1023,1023,4092,16744464,47380,setdown
/dev/fakeUSB0,1023,1023,1023,1023,4092,16744464,47400,setdown
/dev/fakeUSB0,1023,1023,1023,1023,4092,16744464,47420,setdown
/dev/fakeUSB0,1011,1023,1023,1007,4064,16516096,47440,setdown
/dev/fakeUSB0,1023,1023,1023,1006,4075,16605625,47460,setdown
/dev/fakeUSB0,1023,1023,1023,1023,4092,16744464,47480,setdown
/dev/fakeUSB0,1023,1023,1023,999,4068,16548624,47500,setdown
/dev/fakeUSB0,1023,1023,1023,1003,4072,16581184,47520,setdown
/dev/fakeUSB0,1020,1023,1023,1015,4081,16654561,47540,setdown
/dev/fakeUSB0,1023,1023,1023,1023,4092,16744464,47560,setdown
/dev/fakeUSB0,1023,1023,1011,1023,4080,16646400,47580,setdown
/dev/fakeUSB0,1023,1023,1023,999,4068,16548624,47600,setdown
/dev/fakeUSB0,1023,1023,1023,1004,4073,16589329,47620,setdown
/dev/fakeUSB0,1023,1023,1023,1023,4092,16744464,47640,setdown
/dev/fakeUSB0,1023,1023,1015,1023,4084,16679056,47660,setdown
/dev/fakeUSB0,1023,1017,1023,1007,4070,16564900,47680,setdown
/dev/fakeUSB0,1023,1023,1023,1019,4088,16711744,47700,setdown
/dev/fakeUSB0,995,1023,1021,1023,4062,16499844,47720,setdown
/dev/fakeUSB0,1023,1009,1015,1021,4068,16548624,47740,setdown
/dev/fakeUSB0,1023,1023,1022,1023,4091,16736281,47760,setdown
/dev/fakeUSB0,1023,1023,1017,1015,4078,16630084,47780,setdown
/dev/fakeUSB0,1023,999,1023,1023,4068,16548624,47800,setdown
/dev/fakeUSB0,1023,1012,1004,1023,4062,16499844,47820,setdown
/dev/fakeUSB0,1023,1023,1023,1023,4092,16744464,47840,setdown
/dev/fakeUSB0,1015,1003,1023,1023,4064,16516096,47860,setdown
/dev/fakeUSB0,1013,1023,1023,1023,4082,16662724,47880,setdown
/dev/fakeUSB0,1023,1023,1023,1023,4092,16744464,47900,setdown
/dev/fakeUSB0,1023,1023,1023,1023,4092,16744464,47920,setdown
/dev/fakeUSB0,1009,1023,1023,1023,4078,16630084,47940,setdown
/dev/fakeUSB0,1023,1023,1023,1023,4092,16744464,47960,setdown
/dev/fakeUSB0,1023,1023,1023,1019,4088,16711744,47980,setdown
/dev/fakeUSB0,1023,1023,1023,1023,4092,16744464,48000,setdown
/dev/fakeUSB0,1023,1023,1023,1023,4092,16744464,48020,setdown
/dev/fakeUSB0,1023,1023,1023,1023,4092,16744464,48040,setdown
/dev/fakeUSB0,1023,1023,1003,1023,4072,16581184,48060,setdown
/dev/fakeUSB0,1023,1023,1023,1023,4092,16744464,48080,setdown
/dev/fakeUSB0,1023,1023,1023,1023,4092,16744464,48100,setdown
/dev/fakeUSB0,1023,1023,1012,1023,4081,16654561,48120,setdown
/dev/fakeUSB0,1023,1023,1023,1023,4092,16744464,48140,setdown
/dev/fakeUSB0,1023,1015,1019,1023,4080,16646400,48160,setdown
/dev/fakeUSB0,1023,1023,1010,1023,4079,16638241,48180,setdown
/dev/fakeUSB0,1023,1011,1023,1023,4080,16646400,48200,setdown
/dev/fakeUSB0,1023,1009,1023,1023,4078,16630084,48220,setdown
/dev/fakeUSB0,1023,1014,1020,1023,4080,16646400,48240,setdown
/dev/fakeUSB0,1023,1023,1023,1020,4089,16719921,48260,setdown
/dev/fakeUSB0,1004,1005,1023,1019,4051,16410601,48280,setdown
/dev/fakeUSB0,1023,1023,1002,1023,4071,16573041,48300,setdown
/dev/fakeUSB0,1023,1023,1023,1023,4092,16744464,48320,setdown
/dev/fakeUSB0,1023,997,1011,1023,4054,16434916,48340,setdown
/dev/fakeUSB0,1023,1023,1023,1023,4092,16744464,48360,setdown
/dev/fakeUSB0,1015,1020,1023,1023,4081,16654561,48380,setdown
/dev/fakeUSB0,1023,1017,1023,1023,4086,16695396,48400,setdown
/dev/fakeUSB0,1023,1023,1023,1023,4092,16744464,48420,setdown
/dev/fakeUSB0,1023,1009,1023,1023,4078,16630084,48440,setdown
/dev/fakeUSB0,1023,1023,1023,1023,4092,16744464,48460,setdown
/dev/fakeUSB0,1023,1023,1023,1023,4092,16744464,48480,setdown
/dev/fakeUSB0,919,1023,1023,1023,3988,15904144,48500,setdown
/dev/fakeUSB0,653,1023,1023,1017,3716,13808656,48520,setdown
/dev/fakeUSB0,488,1023,1023,1015,3549,12595401,48540,setdown
/dev/fakeUSB0,436,1023,1023,1023,3505,12285025,48560,setdown
/dev/fakeUSB0,414,1023,1023,1023,3483,12131289,48580,setdown
/dev/fakeUSB0,423,1023,1023,1023,3492,12194064,48600,setdown
/dev/fakeUSB0,444,1023,1023,1023,3513,12341169,48620,setdown
/dev/fakeUSB0,469,1023,1010,1023,3525,12425625,48640,setdown
/dev/fakeUSB0,469,1023,1023,997,3512,12334144,48660,setdown
/dev/fakeUSB0,492,1023,1023,1023,3561,12680721,48680,setdown
/dev/fakeUSB0,501,1023,1023,1019,3566,12716356,48700,setdown
/dev/fakeUSB0,499,1005,1006,1023,3533,12482089,48720,setdown
/dev/fakeUSB0,499,1019,1023,1023,3564,12702096,48740,setdown
/dev/fakeUSB0,487,1023,1023,1023,3556,12645136,48760,setdown
/dev/fakeUSB0,480,1023,1023,1017,3543,12552849,48780,setdown
/dev/fakeUSB0,489,1021,1023,1023,3556,12645136,48800,setdown
/dev/fakeUSB0,488,1021,1023,1023,3555,12638025,48820,setdown
/dev/fakeUSB0,488,1023,1003,1023,3537,12510369,48840,setdown
/dev/fakeUSB0,479,1023,1023,1020,3545,12567025,48860,setdown
/dev/fakeUSB0,477,1003,1003,1023,3506,12292036,48880,setdown
/dev/fakeUSB0,480,995,1012,1023,3510,12320100,48900,setdown
/dev/fakeUSB0,485,1007,1023,1023,3538,12517444,48920,setdown
/dev/fakeUSB0,482,1023,1023,1023,3551,12609601,48940,setdown
/dev/fakeUSB0,485,1011,1023,1023,3542,12545764,48960,setdown
/dev/fakeUSB0,489,1023,1023,1023,3558,12659364,48980,setdown
/dev/fakeUSB0,483,1023,1023,1023,3552,12616704,49000,setdown
/dev/fakeUSB0,492,1023,1023,1023,3561,12680721,49020,setdown
/dev/fakeUSB0,483,1017,1023,1023,3546,12574116,49040,setdown
/dev/fakeUSB0,489,1023,1023,1023,3558,12659364,49060,setdown
/dev/fakeUSB0,468,1023,1023,1023,3537,12510369,49080,setdown
/dev/fakeUSB0,481,1023,1023,1023,3550,12602500,49100,setdown
/dev/fakeUSB0,471,1023,1023,1023,3540,12531600,49120,setdown
/dev/fakeUSB0,484,1023,1023,999,3529,12453841,49140,setdown
/dev/fakeUSB0,479,1023,1010,1023,3535,12496225,49160,setdown
/dev/fakeUSB0,477,1023,1023,1023,3546,12574116,49180,setdown
/dev/fakeUSB0,487,1023,1001,1023,3534,12489156,49200,setdown
/dev/fakeUSB0,491,1006,1023,1001,3521,12397441,49220,setdown
/dev/fakeUSB0,484,1023,1005,1019,3531,12467961,49240,setdown
/dev/fakeUSB0,483,1023,991,999,3496,12222016,49260,setdown
/dev/fakeUSB0,469,1015,1023,1023,3530,12460900,49280,setdown
/dev/fakeUSB0,478,1019,1004,1023,3524,12418576,49300,setdown
/dev/fakeUSB0,468,1002,1023,998,3491,12187081,49320,setdown
/dev/fakeUSB0,475,1021,1007,1023,3526,12432676,49340,setdown
/dev/fakeUSB0,482,1023,1013,1023,3541,12538681,49360,setdown
/dev/fakeUSB0,481,1023,997,1023,3524,12418576,49380,setdown
/dev/fakeUSB0,491,1023,1023,1023,3560,12673600,49400,setdown
/dev/fakeUSB0,489,1015,1023,1023,3550,12602500,49420,setdown
/dev/fakeUSB0,488,1023,1023,1023,3557,12652249,49440,setdown
/dev/fakeUSB0,488,1023,1023,1023,3557,12652249,49460,setdown
/dev/fakeUSB0,489,1023,1023,1023,3558,12659364,49480,setdown
/dev/fakeUSB0,475,1022,1023,1023,3543,12552849,49500,setdown
/dev/fakeUSB0,476,1020,1023,1023,3542,12545764,49520,setdown
/dev/fakeUSB0,460,1023,1023,1023,3529,12453841,49540,setdown
/dev/fakeUSB0,468,1023,1023,1007,3521,12397441,49560,setdown
/dev/fakeUSB0,461,1023,1023,1023,3530,12460900,49580,setdown
/dev/fakeUSB0,455,1023,1023,1023,3524,12418576,49600,setdown
/dev/fakeUSB0,466,1023,1023,1022,3534,12489156,49620,setdown
/dev/fakeUSB0,474,1023,1023,1011,3531,12467961,49640,setdown
/dev/fakeUSB0,468,1023,1023,993,3507,12299049,49660,setdown
/dev/fakeUSB0,486,1023,1021,1005,3535,12496225,49680,setdown
/dev/fakeUSB0,473,1023,1023,997,3516,12362256,49700,setdown
/dev/fakeUSB0,478,1023,1010,1023,3534,12489156,49720,setdown
/dev/fakeUSB0,469,1023,1023,1023,3538,12517444,49740,setdown
/dev/fakeUSB0,473,1015,999,1023,3510,12320100,49760,setdown
/dev/fakeUSB0,466,1015,995,1023,3499,12243001,49780,setdown
/dev/fakeUSB0,457,1005,1023,1011,3496,12222016,49800,setdown
/dev/fakeUSB0,452,1013,995,1023,3483,12131289,49820,setdown
/dev/fakeUSB0,464,1017,1023,1023,3527,12439729,49840,setdown
/dev/fakeUSB0,467,1004,709,1023,3203,10259209,49860,setdown
/dev/fakeUSB0,473,1003,555,1023,3054,9326916,49880,setdown
/dev/fakeUSB0,492,1023,480,1004,2999,8994001,49900,setdown
/dev/fakeUSB0,490,1023,439,1013,2965,8791225,49920,setdown
/dev/fakeUSB0,491,996,432,1023,2942,8655364,49940,setdown
/dev/fakeUSB0,484,1023,444,1023,2974,8844676,49960,setdown
/dev/fakeUSB0,477,1007,482,1023,2989,8934121,49980,setdown
/dev/fakeUSB0,460,1023,491,1023,2997,8982009,50000,setdown
/dev/fakeUSB0,463,1015,505,1023,3006,9036036,50020,setdown
/dev/fakeUSB0,460,1005,499,1023,2987,8922169,50040,setdown
/dev/fakeUSB0,465,1023,515,1023,3026,9156676,50060,setdown
/dev/fakeUSB0,472,1023,499,1023,3017,9102289,50080,setdown
/dev/fakeUSB0,479,1023,511,1023,3036,9217296,50100,setdown
/dev/fakeUSB0,476,1023,492,1006,2997,8982009,50120,setdown
/dev/fakeUSB0,487,1023,514,1009,3033,9199089,50140,setdown
/dev/fakeUSB0,476,1023,483,1023,3005,9030025,50160,setdown
/dev/fakeUSB0,477,1023,502,839,2841,8071281,50180,setdown
/dev/fakeUSB0,469,1023,488,622,2602,6770404,50200,setdown
/dev/fakeUSB0,470,1020,506,515,2511,6305121,50220,setdown
/dev/fakeUSB0,462,1023,489,440,2414,5827396,50240,setdown
/dev/fakeUSB0,474,1014,498,433,2419,5851561,50260,setdown
/dev/fakeUSB0,479,1004,497,434,2414,5827396,50280,setdown
/dev/fakeUSB0,482,1010,501,460,2453,6017209,50300,setdown
/dev/fakeUSB0,471,1023,488,476,2458,6041764,50320,setdown
/dev/fakeUSB0,480,1023,490,493,2486,6180196,50340,setdown
/dev/fakeUSB0,485,1023,494,501,2503,6265009,50360,setdown
/dev/fakeUSB0,480,813,486,494,2273,5166529,50380,setdown
/dev/fakeUSB0,485,621,491,492,2089,4363921,50400,setdown
/dev/fakeUSB0,470,495,484,492,1941,3767481,50420,setdown
/dev/fakeUSB0,476,444,491,497,1908,3640464,50440,setdown
/dev/fakeUSB0,472,424,482,496,1874,3511876,50460,setdown
/dev/fakeUSB0,468,447,495,498,1908,3640464,50480,setdown
/dev/fakeUSB0,474,449,488,486,1897,3598609,50500,setdown
/dev/fakeUSB0,477,491,490,490,1948,3794704,50520,setdown
/dev/fakeUSB0,477,496,473,489,1935,3744225,50540,setdown
/dev/fakeUSB0,484,512,495,486,1977,3908529,50560,setdown
/dev/fakeUSB0,486,508,486,490,1970,3880900,50580,setdown
/dev/fakeUSB0,489,517,501,499,2006,4024036,50600,setdown
/dev/fakeUSB0,479,501,471,488,1939,3759721,50620,setdown
/dev/fakeUSB0,478,509,498,491,1976,3904576,50640,setdown
/dev/fakeUSB0,463,485,479,476,1903,3621409,50660,setdown
/dev/fakeUSB0,465,494,484,485,1928,3717184,50680,setdown
/dev/fakeUSB0,461,486,477,485,1909,3644281,50700,setdown
/dev/fakeUSB0,468,496,492,484,1940,3763600,50720,setdown
/dev/fakeUSB0,467,487,480,487,1921,3690241,50740,setdown
/dev/fakeUSB0,469,492,485,493,1939,3759721,50760,setdown
/dev/fakeUSB0,475,492,490,487,1944,3779136,50780,setdown
/dev/fakeUSB0,481,498,487,492,1958,3833764,50800,setdown
/dev/fakeUSB0,478,492,487,483,1940,3763600,50820,setdown
/dev/fakeUSB0,475,493,475,477,1920,3686400,50840,setdown
/dev/fakeUSB0,476,496,490,504,1966,3865156,50860,setdown
/dev/fakeUSB0,476,486,484,482,1928,3717184,50880,setdown
/dev/fakeUSB0,474,496,489,488,1947,3790809,50900,setdown
/dev/fakeUSB0,470,488,474,479,1911,3651921,50920,setdown
/dev/fakeUSB0,472,493,494,480,1939,3759721,50940,setdown
/dev/fakeUSB0,472,482,471,483,1908,3640464,50960,setdown
/dev/fakeUSB0,472,496,495,485,1948,3794704,50980,setdown
/dev/fakeUSB0,475,482,474,478,1909,3644281,51000,setdown
/dev/fakeUSB0,471,491,493,479,1934,3740356,51020,setdown
/dev/fakeUSB0,476,482,479,471,1908,3640464,51040,setdown
/dev/fakeUSB0,479,493,496,487,1955,3822025,51060,setdown
/dev/fakeUSB0,474,480,472,478,1904,3625216,51080,setdown
/dev/fakeUSB0,479,499,487,487,1952,3810304,51100,setdown
/dev/fakeUSB0,473,479,468,474,1894,3587236,51120,setdown
/dev/fakeUSB0,476,495,492,484,1947,3790809,51140,setdown
/dev/fakeUSB0,468,480,485,492,1925,3705625,51160,setdown
/dev/fakeUSB0,476,500,492,491,1959,3837681,51180,setdown
/dev/fakeUSB0,475,482,483,484,1924,3701776,51200,setdown
/dev/fakeUSB0,478,488,480,490,1936,3748096,51220,setdown
/dev/fakeUSB0,475,484,480,481,1920,3686400,51240,setdown
/dev/fakeUSB0,465,487,483,485,1920,3686400,51260,setdown
/dev/fakeUSB0,465,478,481,476,1900,3610000,51280,setdown
/dev/fakeUSB0,465,485,476,478,1904,3625216,51300,setdown
/dev/fakeUSB0,480,490,486,480,1936,3748096,51320,setdown
/dev/fakeUSB0,478,482,476,484,1920,3686400,51340,setdown
/dev/fakeUSB0,480,495,489,484,1948,3794704,51360,setdown
/dev/fakeUSB0,478,485,478,481,1922,3694084,51380,setdown
/dev/fakeUSB0,474,493,484,499,1950,3802500,51400,setdown
/dev/fakeUSB0,478,487,476,475,1916,3671056,51420,setdown
/dev/fakeUSB0,468,495,481,488,1932,3732624,51440,setdown
/dev/fakeUSB0,472,476,466,476,1890,3572100,51460,setdown
/dev/fakeUSB0,481,493,492,478,1944,3779136,51480,setdown
/dev/fakeUSB0,471,482,473,472,1898,3602404,51500,setdown
/dev/fakeUSB0,476,490,480,486,1932,3732624,51520,glitch
/dev/fakeUSB0,471,472,474,473,1890,3572100,51540,glitch
/dev/fakeUSB0,480,486,492,487,1945,3783025,51560,glitch
/dev/fakeUSB0,476,481,468,474,1899,3606201,51580,glitch
/dev/fakeUSB0,484,491,489,483,1947,3790809,51600,glitch
/dev/fakeUSB0,476,472,465,473,1886,3556996,51620,glitch
/dev/fakeUSB0,476,493,487,474,1930,3724900,51640,glitch
/dev/fakeUSB0,482,483,466,479,1910,3648100,51660,glitch
/dev/fakeUSB0,474,486,480,481,1921,3690241,51680,glitch
/dev/fakeUSB0,471,479,479,476,1905,3629025,51700,glitch
/dev/fakeUSB0,470,483,486,479,1918,3678724,51720,glitch
/dev/fakeUSB0,474,478,471,481,1904,3625216,51740,glitch
/dev/fakeUSB0,475,479,481,484,1919,3682561,51760,glitch
/dev/fakeUSB0,479,483,482,473,1917,3674889,51780,glitch
/dev/fakeUSB0,472,485,483,479,1919,3682561,51800,glitch
/dev/fakeUSB0,477,490,478,483,1928,3717184,51820,glitch
/dev/fakeUSB0,476,484,479,482,1921,3690241,51840,glitch
/dev/fakeUSB0,478,486,484,480,1928,3717184,51860,glitch
/dev/fakeUSB0,477,480,480,477,1914,3663396,51880,glitch
/dev/fakeUSB0,474,485,488,475,1922,3694084,51900,glitch
/dev/fakeUSB0,468,475,472,475,1890,3572100,51920,glitch
/dev/fakeUSB0,451,483,491,480,1905,3629025,51940,glitch
/dev/fakeUSB0,474,468,472,469,1883,3545689,51960,glitch
/dev/fakeUSB0,479,489,484,483,1935,3744225,51980,glitch
/dev/fakeUSB0,465,468,482,472,1887,3560769,52000,glitch
/dev/fakeUSB0,477,491,489,478,1935,3744225,52020,glitch
/dev/fakeUSB0,472,478,481,467,1898,3602404,52040,glitch
/dev/fakeUSB0,477,487,499,476,1939,3759721,52060,glitch
/dev/fakeUSB0,469,478,475,468,1890,3572100,52080,glitch
/dev/fakeUSB0,480,488,491,478,1937,3751969,52100,glitch
/dev/fakeUSB0,468,470,465,476,1879,3530641,52120,glitch
/dev/fakeUSB0,472,485,479,479,1915,3667225,52140,glitch
/dev/fakeUSB0,476,465,472,476,1889,3568321,52160,glitch
/dev/fakeUSB0,467,476,475,483,1901,3613801,52180,glitch
/dev/fakeUSB0,468,473,468,474,1883,3545689,52200,glitch
/dev/fakeUSB0,475,468,468,473,1884,3549456,52220,glitch
/dev/fakeUSB0,475,469,463,476,1883,3545689,52240,glitch
/dev/fakeUSB0,475,471,468,471,1885,3553225,52260,glitch
/dev/fakeUSB0,473,471,481,475,1900,3610000,52280,glitch
/dev/fakeUSB0,471,471,469,469,1880,3534400,52300,glitch
/dev/fakeUSB0,470,480,488,474,1912,3655744,52320,glitch
/dev/fakeUSB0,471,473,464,467,1875,3515625,52340,glitch
/dev/fakeUSB0,475,485,476,473,1909,3644281,52360,glitch
/dev/fakeUSB0,468,479,471,476,1894,3587236,52380,glitch
/dev/fakeUSB0,472,492,480,480,1924,3701776,52400,glitch
/dev/fakeUSB0,472,470,473,472,1887,3560769,52420,glitch
/dev/fakeUSB0,472,481,484,479,1916,3671056,52440,glitch
/dev/fakeUSB0,470,466,470,478,1884,3549456,52460,glitch
/dev/fakeUSB0,475,483,486,484,1928,3717184,52480,glitch
/dev/fakeUSB0,469,477,465,472,1883,3545689,52500,glitch
/dev/fakeUSB0,477,479,476,476,1908,3640464,52520,glitch
/dev/fakeUSB0,468,471,463,479,1881,3538161,52540,glitch
/dev/fakeUSB0,483,487,484,483,1937,3751969,52560,glitch
/dev/fakeUSB0,484,477,467,481,1909,3644281,52580,glitch
/dev/fakeUSB0,492,494,495,483,1964,3857296,52600,glitch
/dev/fakeUSB0,492,489,477,480,1938,3755844,52620,glitch
/dev/fakeUSB0,497,513,494,476,1980,3920400,52640,glitch
/dev/fakeUSB0,494,517,480,480,1971,3884841,52660,glitch
/dev/fakeUSB0,494,524,476,475,1969,3876961,52680,glitch
/dev/fakeUSB0,493,520,484,464,1961,3845521,52700,glitch
/dev/fakeUSB0,492,517,483,469,1961,3845521,52720,glitch
/dev/fakeUSB0,483,516,475,468,1942,3771364,52740,glitch
/dev/fakeUSB0,472,494,473,472,1911,3651921,52760,glitch
/dev/fakeUSB0,477,484,471,472,1904,3625216,52780,glitch
/dev/fakeUSB0,470,473,469,480,1892,3579664,52800,glitch
/dev/fakeUSB0,484,509,480,473,1946,3786916,52820,glitch
/dev/fakeUSB0,482,715,471,472,2140,4579600,52840,glitch
/dev/fakeUSB0,489,1004,488,483,2464,6071296,52860,glitch
/dev/fakeUSB0,494,1015,475,477,2461,6056521,52880,glitch
/dev/fakeUSB0,588,1023,489,476,2576,6635776,52900,glitch
/dev/fakeUSB0,1023,1023,461,464,2971,8826841,52920,glitch
/dev/fakeUSB0,1012,1005,489,468,2974,8844676,52940,glitch
/dev/fakeUSB0,1023,1001,478,460,2962,8773444,52960,glitch
/dev/fakeUSB0,1023,1023,490,474,3010,9060100,52980,glitch
/dev/fakeUSB0,1019,1023,469,475,2986,8916196,53000,glitch
/dev/fakeUSB0,1023,1015,492,476,3006,9036036,53020,glitch
/dev/fakeUSB0,1023,721,484,473,2701,7295401,53040,glitch
/dev/fakeUSB0,1023,546,490,475,2534,6421156,53060,glitch
/dev/fakeUSB0,1023,432,473,466,2394,5731236,53080,glitch
/dev/fakeUSB0,1009,383,479,476,2347,5508409,53100,glitch
/dev/fakeUSB0,1023,220,475,469,2187,4782969,53120,glitch
/dev/fakeUSB0,1013,0,481,477,1971,3884841,53140,glitch
/dev/fakeUSB0,991,0,476,472,1939,3759721,53160,glitch
/dev/fakeUSB0,680,0,476,473,1629,2653641,53180,glitch
/dev/fakeUSB0,500,0,475,471,1446,2090916,53200,glitch
/dev/fakeUSB0,418,24,481,469,1392,1937664,53220,glitch
/dev/fakeUSB0,404,173,477,467,1521,2313441,53240,glitch
/dev/fakeUSB0,417,322,468,478,1685,2839225,53260,glitch
/dev/fakeUSB0,448,448,476,471,1843,3396649,53280,glitch
/dev/fakeUSB0,463,515,472,471,1921,3690241,53300,glitch
/dev/fakeUSB0,480,546,484,479,1989,3956121,53320,glitch
/dev/fakeUSB0,484,511,465,478,1938,3755844,53340,glitch
/dev/fakeUSB0,488,487,483,481,1939,3759721,53360,glitch
/dev/fakeUSB0,478,434,472,476,1860,3459600,53380,glitch
/dev/fakeUSB0,477,417,479,472,1845,3404025,53400,glitch
/dev/fakeUSB0,477,396,464,466,1803,3250809,53420,glitch
/dev/fakeUSB0,479,412,476,475,1842,3392964,53440,glitch
/dev/fakeUSB0,485,411,464,472,1832,3356224,53460,glitch
/dev/fakeUSB0,480,431,485,471,1867,3485689,53480,glitch
/dev/fakeUSB0,473,410,474,479,1836,3370896,53500,glitch
/dev/fakeUSB0,478,405,483,482,1848,3415104,53520,glitch
/dev/fakeUSB0,476,404,476,484,1840,3385600,53540,glitch
/dev/fakeUSB0,485,425,484,487,1881,3538161,53560,glitch
/dev/fakeUSB0,479,429,479,487,1874,3511876,53580,glitch
/dev/fakeUSB0,484,446,489,476,1895,3591025,53600,glitch
/dev/fakeUSB0,487,436,469,468,1860,3459600,53620,glitch
/dev/fakeUSB0,480,436,484,475,1875,3515625,53640,glitch
/dev/fakeUSB0,476,437,481,473,1867,3485689,53660,glitch
/dev/fakeUSB0,473,443,468,467,1851,3426201,53680,glitch
/dev/fakeUSB0,477,458,482,477,1894,3587236,53700,glitch
/dev/fakeUSB0,476,467,467,471,1881,3538161,53720,glitch
/dev/fakeUSB0,471,485,480,471,1907,3636649,53740,glitch
/dev/fakeUSB0,472,484,471,475,1902,3617604,53760,glitch
/dev/fakeUSB0,474,476,476,471,1897,3598609,53780,glitch
/dev/fakeUSB0,473,459,467,467,1866,3481956,53800,glitch
/dev/fakeUSB0,474,461,476,481,1892,3579664,53820,glitch
/dev/fakeUSB0,473,441,473,476,1863,3470769,53840,glitch
/dev/fakeUSB0,473,464,484,473,1894,3587236,53860,glitch
/dev/fakeUSB0,470,448,466,472,1856,3444736,53880,glitch
/dev/fakeUSB0,470,468,481,475,1894,3587236,53900,glitch
/dev/fakeUSB0,471,460,466,461,1858,3452164,53920,glitch
/dev/fakeUSB0,473,476,480,472,1901,3613801,53940,glitch
/dev/fakeUSB0,472,464,466,468,1870,3496900,53960,glitch
/dev/fakeUSB0,465,473,481,474,1893,3583449,53980,glitch
/dev/fakeUSB0,462,463,464,477,1866,3481956,54000,glitch
/dev/fakeUSB0,457,480,476,476,1889,3568321,54020,glitch
/dev/fakeUSB0,452,471,467,466,1856,3444736,54040,glitch
/dev/fakeUSB0,459,478,480,477,1894,3587236,54060,glitch
/dev/fakeUSB0,460,467,472,471,1870,3496900,54080,glitch
/dev/fakeUSB0,468,478,471,477,1894,3587236,54100,glitch
/dev/fakeUSB0,472,475,480,479,1906,3632836,54120,glitch
/dev/fakeUSB0,480,482,473,479,1914,3663396,54140,glitch
/dev/fakeUSB0,475,476,482,476,1909,3644281,54160,glitch
/dev/fakeUSB0,483,476,477,480,1916,3671056,54180,glitch
/dev/fakeUSB0,456,470,474,481,1881,3538161,54200,glitch
/dev/fakeUSB0,468,469,466,468,1871,3500641,54220,glitch
/dev/fakeUSB0,476,475,464,477,1892,3579664,54240,glitch
/dev/fakeUSB0,479,461,463,472,1875,3515625,54260,glitch
/dev/fakeUSB0,472,480,476,475,1903,3621409,54280,glitch
/dev/fakeUSB0,468,467,464,467,1866,3481956,54300,glitch
/dev/fakeUSB0,468,475,482,470,1895,3591025,54320,glitch
/dev/fakeUSB0,465,469,475,471,1880,3534400,54340,glitch
/dev/fakeUSB0,467,481,480,477,1905,3629025,54360,glitch
/dev/fakeUSB0,468,463,468,469,1868,3489424,54380,glitch
/dev/fakeUSB0,479,476,475,475,1905,3629025,54400,glitch
/dev/fakeUSB0,481,469,465,461,1876,3519376,54420,glitch
/dev/fakeUSB0,493,489,486,469,1937,3751969,54440,glitch
/dev/fakeUSB0,492,470,467,461,1890,3572100,54460,glitch
/dev/fakeUSB0,487,482,485,470,1924,3701776,54480,glitch
/dev/fakeUSB0,479,466,476,464,1885,3553225,54500,glitch
/dev/fakeUSB0,470,476,485,471,1902,3617604,54520,glitch
/dev/fakeUSB0,462,465,466,464,1857,3448449,54540,glitch
/dev/fakeUSB0,466,482,480,476,1904,3625216,54560,glitch
/dev/fakeUSB0,470,649,478,471,2068,4276624,54580,glitch
/dev/fakeUSB0,490,1023,482,475,2470,6100900,54600,glitch
/dev/fakeUSB0,495,1023,475,469,2462,6061444,54620,glitch
/dev/fakeUSB0,439,1011,485,467,2402,5769604,54640,glitch
/dev/fakeUSB0,370,1023,481,476,2350,5522500,54660,glitch
/dev/fakeUSB0,343,1012,470,472,2297,5276209,54680,glitch
/dev/fakeUSB0,188,1021,475,473,2157,4652649,54700,glitch
/dev/fakeUSB0,0,1023,461,468,1952,3810304,54720,glitch
/dev/fakeUSB0,0,827,471,473,1771,3136441,54740,glitch
/dev/fakeUSB0,0,8,463,467,938,879844,54760,glitch
/dev/fakeUSB0,0,0,484,472,956,913936,54780,glitch
/dev/fakeUSB0,0,0,468,476,944,891136,54800,glitch
/dev/fakeUSB0,0,0,484,476,960,921600,54820,glitch
/dev/fakeUSB0,0,0,475,469,944,891136,54840,glitch
/dev/fakeUSB0,0,0,481,471,952,906304,54860,glitch
/dev/fakeUSB0,0,0,468,465,933,870489,54880,glitch
/dev/fakeUSB0,0,38,479,474,991,982081,54900,glitch
/dev/fakeUSB0,160,269,464,469,1362,1855044,54920,glitch
/dev/fakeUSB0,396,456,483,478,1813,3286969,54940,glitch
/dev/fakeUSB0,528,532,468,464,1992,3968064,54960,glitch
/dev/fakeUSB0,573,570,480,469,2092,4376464,54980,glitch
/dev/fakeUSB0,558,540,463,468,2029,4116841,55000,glitch
/dev/fakeUSB0,532,520,473,465,1990,3960100,55020,glitch
/dev/fakeUSB0,491,481,460,468,1900,3610000,55040,glitch
/dev/fakeUSB0,468,474,482,470,1894,3587236,55060,glitch
/dev/fakeUSB0,460,459,473,464,1856,3444736,55080,glitch
/dev/fakeUSB0,458,459,476,461,1854,3437316,55100,glitch
/dev/fakeUSB0,453,464,475,463,1855,3441025,55120,glitch
/dev/fakeUSB0,460,468,465,463,1856,3444736,55140,glitch
/dev/fakeUSB0,459,471,480,466,1876,3519376,55160,glitch
/dev/fakeUSB0,463,464,475,468,1870,3496900,55180,glitch
/dev/fakeUSB0,461,479,471,470,1881,3538161,55200,glitch
/dev/fakeUSB0,469,475,472,476,1892,3579664,55220,glitch
/dev/fakeUSB0,471,472,473,473,1889,3568321,55240,glitch
/dev/fakeUSB0,464,465,471,471,1871,3500641,55260,glitch
/dev/fakeUSB0,467,481,489,477,1914,3663396,55280,glitch
/dev/fakeUSB0,459,464,465,460,1848,3415104,55300,glitch
/dev/fakeUSB0,463,476,505,480,1924,3701776,55320,glitch
/dev/fakeUSB0,464,457,465,465,1851,3426201,55340,glitch
/dev/fakeUSB0,464,472,487,468,1891,3575881,55360,glitch
/dev/fakeUSB0,464,463,468,463,1858,3452164,55380,glitch
/dev/fakeUSB0,468,487,491,472,1918,3678724,55400,glitch
/dev/fakeUSB0,467,467,465,466,1865,3478225,55420,glitch
/dev/fakeUSB0,465,479,480,469,1893,3583449,55440,glitch
/dev/fakeUSB0,465,473,464,475,1877,3523129,55460,glitch
/dev/fakeUSB0,464,480,468,469,1881,3538161,55480,glitch
/dev/fakeUSB0,463,466,472,471,1872,3504384,55500,glitch
/dev/fakeUSB0,471,481,480,468,1900,3610000,55520,glitch
/dev/fakeUSB0,474,465,463,467,1869,3493161,55540,glitch
/dev/fakeUSB0,463,476,475,475,1889,3568321,55560,glitch
/dev/fakeUSB0,468,471,465,464,1868,3489424,55580,glitch
/dev/fakeUSB0,465,473,469,467,1874,3511876,55600,glitch
/dev/fakeUSB0,459,472,476,472,1879,3530641,55620,glitch
/dev/fakeUSB0,464,470,465,470,1869,3493161,55640,glitch
/dev/fakeUSB0,470,476,481,476,1903,3621409,55660,glitch
/dev/fakeUSB0,469,466,481,464,1880,3534400,55680,glitch
/dev/fakeUSB0,467,470,478,475,1890,3572100,55700,glitch
/dev/fakeUSB0,465,470,468,468,1871,3500641,55720,glitch
/dev/fakeUSB0,467,486,478,469,1900,3610000,55740,glitch
/dev/fakeUSB0,472,472,461,468,1873,3508129,55760,glitch
/dev/fakeUSB0,470,484,486,470,1910,3648100,55780,glitch
/dev/fakeUSB0,465,466,462,472,1865,3478225,55800,glitch
/dev/fakeUSB0,475,482,476,483,1916,3671056,55820,glitch
/dev/fakeUSB0,468,465,469,478,1880,3534400,55840,glitch
/dev/fakeUSB0,467,473,469,494,1903,3621409,55860,glitch
/dev/fakeUSB0,459,462,465,467,1853,3433609,55880,glitch
/dev/fakeUSB0,471,470,477,476,1894,3587236,55900,glitch
/dev/fakeUSB0,460,460,460,474,1854,3437316,55920,glitch
/dev/fakeUSB0,470,475,488,474,1907,3636649,55940,glitch
/dev/fakeUSB0,462,472,460,476,1870,3496900,55960,glitch
/dev/fakeUSB0,479,480,481,471,1911,3651921,55980,glitch
/dev/fakeUSB0,475,473,471,469,1888,3564544,56000,glitch
/dev/fakeUSB0,472,483,487,472,1914,3663396,56020,glitch
/dev/fakeUSB0,470,472,472,468,1882,3541924,56040,glitch
/dev/fakeUSB0,477,474,488,468,1907,3636649,56060,glitch
/dev/fakeUSB0,469,468,480,468,1885,3553225,56080,glitch
/dev/fakeUSB0,470,471,476,466,1883,3545689,56100,glitch
/dev/fakeUSB0,465,470,480,475,1890,3572100,56120,glitch
/dev/fakeUSB0,465,464,468,468,1865,3478225,56140,glitch
/dev/fakeUSB0,463,477,474,471,1885,3553225,56160,glitch
/dev/fakeUSB0,467,470,464,470,1871,3500641,56180,glitch
/dev/fakeUSB0,474,476,477,474,1901,3613801,56200,glitch
/dev/fakeUSB0,481,471,463,470,1885,3553225,56220,glitch
/dev/fakeUSB0,487,488,485,476,1936,3748096,56240,glitch
/dev/fakeUSB0,481,480,477,466,1904,3625216,56260,glitch
/dev/fakeUSB0,477,492,489,474,1932,3732624,56280,glitch
/dev/fakeUSB0,475,491,477,468,1911,3651921,56300,glitch
/dev/fakeUSB0,483,508,489,480,1960,3841600,56320,glitch
/dev/fakeUSB0,481,499,492,471,1943,3775249,56340,glitch
/dev/fakeUSB0,479,511,489,474,1953,3814209,56360,glitch
/dev/fakeUSB0,483,498,466,471,1918,3678724,56380,glitch
/dev/fakeUSB0,485,538,492,473,1988,3952144,56400,glitch
/dev/fakeUSB0,472,553,463,463,1951,3806401,56420,glitch
/dev/fakeUSB0,475,607,480,466,2028,4112784,56440,glitch
/dev/fakeUSB0,464,604,469,466,2003,4012009,56460,glitch
/dev/fakeUSB0,471,580,484,465,2000,4000000,56480,glitch
/dev/fakeUSB0,465,472,476,465,1878,3526884,56500,glitch
/dev/fakeUSB0,465,375,490,464,1794,3218436,56520,glitch
/dev/fakeUSB0,469,324,487,478,1758,3090564,56540,glitch
/dev/fakeUSB0,462,336,478,476,1752,3069504,56560,glitch
/dev/fakeUSB0,452,364,481,469,1766,3118756,56580,glitch
/dev/fakeUSB0,463,406,481,470,1820,3312400,56600,glitch
/dev/fakeUSB0,462,444,478,470,1854,3437316,56620,glitch
/dev/fakeUSB0,459,464,468,476,1867,3485689,56640,glitch
/dev/fakeUSB0,462,470,479,477,1888,3564544,56660,glitch
/dev/fakeUSB0,459,468,471,474,1872,3504384,56680,glitch
/dev/fakeUSB0,459,468,476,475,1878,3526884,56700,glitch
/dev/fakeUSB0,458,454,468,465,1845,3404025,56720,glitch
/dev/fakeUSB0,467,466,484,471,1888,3564544,56740,glitch
/dev/fakeUSB0,470,457,469,468,1864,3474496,56760,glitch
/dev/fakeUSB0,476,474,478,468,1896,3594816,56780,glitch
/dev/fakeUSB0,470,460,466,458,1854,3437316,56800,glitch
/dev/fakeUSB0,468,471,487,476,1902,3617604,56820,glitch
/dev/fakeUSB0,464,458,463,469,1854,3437316,56840,glitch
/dev/fakeUSB0,471,473,479,473,1896,3594816,56860,glitch
/dev/fakeUSB0,463,453,460,466,1842,3392964,56880,glitch
/dev/fakeUSB0,476,480,483,470,1909,3644281,56900,glitch
/dev/fakeUSB0,475,477,469,459,1880,3534400,56920,glitch
/dev/fakeUSB0,475,489,477,479,1920,3686400,56940,glitch
/dev/fakeUSB0,476,478,473,473,1900,3610000,56960,glitch
/dev/fakeUSB0,484,472,479,469,1904,3625216,56980,glitch
/dev/fakeUSB0,472,469,477,468,1886,3556996,57000,glitch
/dev/fakeUSB0,472,465,476,470,1883,3545689,57020,glitch
/dev/fakeUSB0,463,457,477,470,1867,3485689,57040,glitch
/dev/fakeUSB0,464,460,468,476,1868,3489424,57060,glitch
/dev/fakeUSB0,455,466,467,467,1855,3441025,57080,glitch
/dev/fakeUSB0,459,464,460,465,1848,3415104,57100,glitch
/dev/fakeUSB0,464,471,473,469,1877,3523129,57120,glitch
/dev/fakeUSB0,468,465,464,461,1858,3452164,57140,glitch
/dev/fakeUSB0,475,482,476,475,1908,3640464,57160,glitch
/dev/fakeUSB0,474,473,461,465,1873,3508129,57180,glitch
/dev/fakeUSB0,476,484,481,472,1913,3659569,57200,glitch
/dev/fakeUSB0,476,464,468,468,1876,3519376,57220,glitch
/dev/fakeUSB0,475,479,485,469,1908,3640464,57240,glitch
/dev/fakeUSB0,472,464,464,466,1866,3481956,57260,glitch
/dev/fakeUSB0,469,481,478,471,1899,3606201,57280,glitch
/dev/fakeUSB0,469,466,464,461,1860,3459600,57300,glitch
/dev/fakeUSB0,468,478,479,479,1904,3625216,57320,glitch
/dev/fakeUSB0,463,461,468,469,1861,3463321,57340,glitch
/dev/fakeUSB0,461,478,484,482,1905,3629025,57360,glitch
/dev/fakeUSB0,464,467,468,472,1871,3500641,57380,glitch
/dev/fakeUSB0,469,476,478,465,1888,3564544,57400,glitch
/dev/fakeUSB0,467,467,463,461,1858,3452164,57420,glitch
/dev/fakeUSB0,468,485,484,477,1914,3663396,57440,glitch
/dev/fakeUSB0,467,472,472,467,1878,3526884,57460,glitch
/dev/fakeUSB0,474,476,474,473,1897,3598609,57480,glitch
/dev/fakeUSB0,464,472,468,468,1872,3504384,57500,glitch
/dev/fakeUSB0,472,473,476,472,1893,3583449,57520,glitch
/dev/fakeUSB0,464,469,475,472,1880,3534400,57540,glitch
/dev/fakeUSB0,467,471,472,469,1879,3530641,57560,glitch
/dev/fakeUSB0,463,468,470,469,1870,3496900,57580,glitch
/dev/fakeUSB0,467,465,471,474,1877,3523129,57600,glitch
/dev/fakeUSB0,472,472,476,474,1894,3587236,57620,glitch
/dev/fakeUSB0,472,475,468,472,1887,3560769,57640,glitch
/dev/fakeUSB0,465,478,476,468,1887,3560769,57660,glitch
/dev/fakeUSB0,462,462,470,466,1860,3459600,57680,glitch
/dev/fakeUSB0,469,479,480,468,1896,3594816,57700,glitch
/dev/fakeUSB0,472,467,468,467,1874,3511876,57720,glitch
/dev/fakeUSB0,473,483,486,476,1918,3678724,57740,glitch
/dev/fakeUSB0,466,468,468,464,1866,3481956,57760,glitch
/dev/fakeUSB0,473,479,489,469,1910,3648100,57780,glitch
/dev/fakeUSB0,472,463,472,459,1866,3481956,57800,glitch
/dev/fakeUSB0,468,485,482,477,1912,3655744,57820,glitch
/dev/fakeUSB0,468,467,466,475,1876,3519376,57840,glitch
/dev/fakeUSB0,467,480,473,475,1895,3591025,57860,glitch
/dev/fakeUSB0,461,463,469,468,1861,3463321,57880,glitch
/dev/fakeUSB0,465,476,476,469,1886,3556996,57900,glitch
/dev/fakeUSB0,463,473,477,469,1882,3541924,57920,glitch
/dev/fakeUSB0,464,480,473,471,1888,3564544,57940,glitch
/dev/fakeUSB0,464,468,477,463,1872,3504384,57960,glitch
/dev/fakeUSB0,469,474,472,468,1883,3545689,57980,glitch
/dev/fakeUSB0,473,476,476,469,1894,3587236,58000,glitch
/dev/fakeUSB0,484,473,466,472,1895,3591025,58020,quiescent
/dev/fakeUSB0,477,469,469,468,1883,3545689,58040,quiescent
/dev/fakeUSB0,480,476,466,468,1890,3572100,58060,quiescent
/dev/fakeUSB0,469,477,471,462,1879,3530641,58080,quiescent
/dev/fakeUSB0,469,468,465,471,1873,3508129,58100,quiescent
/dev/fakeUSB0,467,472,472,475,1886,3556996,58120,quiescent
/dev/fakeUSB0,471,460,461,469,1861,3463321,58140,quiescent
/dev/fakeUSB0,464,471,474,478,1887,3560769,58160,quiescent
/dev/fakeUSB0,467,460,472,476,1875,3515625,58180,quiescent
/dev/fakeUSB0,473,477,478,476,1904,3625216,58200,quiescent
/dev/fakeUSB0,467,459,469,471,1866,3481956,58220,quiescent
/dev/fakeUSB0,471,478,482,477,1908,3640464,58240,quiescent
/dev/fakeUSB0,471,466,468,460,1865,3478225,58260,quiescent
/dev/fakeUSB0,477,484,473,475,1909,3644281,58280,quiescent
/dev/fakeUSB0,474,464,470,468,1876,3519376,58300,quiescent
/dev/fakeUSB0,466,473,484,478,1901,3613801,58320,quiescent
/dev/fakeUSB0,466,460,463,463,1852,3429904,58340,quiescent
/dev/fakeUSB0,466,479,480,474,1899,3606201,58360,quiescent
/dev/fakeUSB0,466,464,476,468,1874,3511876,58380,quiescent
/dev/fakeUSB0,474,472,476,467,1889,3568321,58400,quiescent
/dev/fakeUSB0,467,468,464,463,1862,3467044,58420,quiescent
/dev/fakeUSB0,469,473,471,468,1881,3538161,58440,quiescent
/dev/fakeUSB0,468,472,468,464,1872,3504384,58460,quiescent
/dev/fakeUSB0,467,480,471,473,1891,3575881,58480,quiescent
/dev/fakeUSB0,464,476,468,472,1880,3534400,58500,quiescent
/dev/fakeUSB0,473,475,472,477,1897,3598609,58520,quiescent
/dev/fakeUSB0,475,476,484,476,1911,3651921,58540,quiescent
/dev/fakeUSB0,467,470,477,472,1886,3556996,58560,quiescent
/dev/fakeUSB0,475,477,479,474,1905,3629025,58580,quiescent
/dev/fakeUSB0,475,465,463,466,1869,3493161,58600,quiescent
/dev/fakeUSB0,471,468,472,470,1881,3538161,58620,quiescent
/dev/fakeUSB0,462,463,463,469,1857,3448449,58640,quiescent
/dev/fakeUSB0,468,468,480,468,1884,3549456,58660,quiescent
/dev/fakeUSB0,460,455,465,461,1841,3389281,58680,quiescent
/dev/fakeUSB0,465,476,477,479,1897,3598609,58700,quiescent
/dev/fakeUSB0,468,469,460,472,1869,3493161,58720,quiescent
/dev/fakeUSB0,476,488,481,477,1922,3694084,58740,quiescent
/dev/fakeUSB0,467,469,460,463,1859,3455881,58760,quiescent
/dev/fakeUSB0,479,485,479,477,1920,3686400,58780,quiescent
/dev/fakeUSB0,468,466,457,468,1859,3455881,58800,quiescent
/dev/fakeUSB0,477,478,471,469,1895,3591025,58820,quiescent
/dev/fakeUSB0,469,463,469,463,1864,3474496,58840,quiescent
/dev/fakeUSB0,474,480,478,469,1901,3613801,58860,quiescent
/dev/fakeUSB0,470,463,472,471,1876,3519376,58880,quiescent
/dev/fakeUSB0,470,474,476,477,1897,3598609,58900,quiescent
/dev/fakeUSB0,455,465,472,461,1853,3433609,58920,quiescent
/dev/fakeUSB0,455,471,476,468,1870,3496900,58940,quiescent
/dev/fakeUSB0,468,468,477,469,1882,3541924,58960,quiescent
/dev/fakeUSB0,468,469,471,465,1873,3508129,58980,quiescent
/dev/fakeUSB0,475,475,464,472,1886,3556996,59000,quiescent
/dev/fakeUSB0,480,472,473,478,1903,3621409,59020,quiescent
/dev/fakeUSB0,481,484,479,473,1917,3674889,59040,quiescent
/dev/fakeUSB0,477,478,473,475,1903,3621409,59060,quiescent
/dev/fakeUSB0,477,483,468,475,1903,3621409,59080,quiescent
/dev/fakeUSB0,472,469,462,467,1870,3496900,59100,quiescent
/dev/fakeUSB0,468,475,480,473,1896,3594816,59120,quiescent
/dev/fakeUSB0,453,460,466,463,1842,3392964,59140,quiescent
/dev/fakeUSB0,454,464,495,464,1877,3523129,59160,quiescent
/dev/fakeUSB0,451,455,465,460,1831,3352561,59180,quiescent
/dev/fakeUSB0,452,466,480,474,1872,3504384,59200,quiescent
/dev/fakeUSB0,460,460,457,462,1839,3381921,59220,quiescent
/dev/fakeUSB0,478,480,481,475,1914,3663396,59240,quiescent
/dev/fakeUSB0,474,469,471,464,1878,3526884,59260,quiescent
/dev/fakeUSB0,484,490,489,476,1939,3759721,59280,quiescent
/dev/fakeUSB0,483,482,464,468,1897,3598609,59300,quiescent
/dev/fakeUSB0,492,488,478,465,1923,3697929,59320,quiescent
/dev/fakeUSB0,477,478,460,460,1875,3515625,59340,quiescent
/dev/fakeUSB0,479,484,483,463,1909,3644281,59360,quiescent
/dev/fakeUSB0,461,461,476,476,1874,3511876,59380,quiescent
/dev/fakeUSB0,459,463,476,467,1865,3478225,59400,quiescent
/dev/fakeUSB0,443,459,473,466,1841,3389281,59420,quiescent
/dev/fakeUSB0,441,457,480,467,1845,3404025,59440,quiescent
/dev/fakeUSB0,445,460,468,469,1842,3392964,59460,quiescent
/dev/fakeUSB0,461,464,462,467,1854,3437316,59480,quiescent
/dev/fakeUSB0,469,468,466,466,1869,3493161,59500,quiescent
/dev/fakeUSB0,487,476,470,465,1898,3602404,59520,quiescent
/dev/fakeUSB0,494,490,476,474,1934,3740356,59540,quiescent
/dev/fakeUSB0,499,487,460,467,1913,3659569,59560,quiescent
/dev/fakeUSB0,498,499,474,470,1941,3767481,59580,quiescent
/dev/fakeUSB0,479,475,469,462,1885,3553225,59600,quiescent
/dev/fakeUSB0,472,476,480,473,1901,3613801,59620,quiescent
/dev/fakeUSB0,454,459,470,462,1845,3404025,59640,quiescent
/dev/fakeUSB0,448,464,489,482,1883,3545689,59660,quiescent
/dev/fakeUSB0,443,453,471,472,1839,3381921,59680,quiescent
/dev/fakeUSB0,452,465,493,476,1886,3556996,59700,quiescent
/dev/fakeUSB0,452,455,464,470,1841,3389281,59720,quiescent
/dev/fakeUSB0,464,473,477,473,1887,3560769,59740,quiescent
/dev/fakeUSB0,466,466,461,465,1858,3452164,59760,quiescent
/dev/fakeUSB0,485,492,480,479,1936,3748096,59780,quiescent
/dev/fakeUSB0,484,479,460,471,1894,3587236,59800,quiescent
/dev/fakeUSB0,495,490,473,477,1935,3744225,59820,quiescent
/dev/fakeUSB0,485,484,458,469,1896,3594816,59840,quiescent
/dev/fakeUSB0,480,484,472,476,1912,3655744,59860,quiescent
/dev/fakeUSB0,464,466,468,461,1859,3455881,59880,quiescent
/dev/fakeUSB0,452,460,472,467,1851,3426201,59900,quiescent
/dev/fakeUSB0,450,457,467,466,1840,3385600,59920,quiescent
/dev/fakeUSB0,445,460,469,468,1842,3392964,59940,quiescent
/dev/fakeUSB0,456,457,466,475,1854,3437316,59960,quiescent
/dev/fakeUSB0,459,466,475,462,1862,3467044,59980,quiescent
/dev/fakeUSB0,467,472,476,464,1879,3530641,60000,quiescent
/dev/fakeUSB0,469,469,475,464,1877,3523129,60020,quiescent
/dev/fakeUSB0,485,488,476,476,1925,3705625,60040,quiescent
/dev/fakeUSB0,486,482,467,469,1904,3625216,60060,quiescent
/dev/fakeUSB0,487,490,472,468,1917,3674889,60080,quiescent
/dev/fakeUSB0,474,477,468,462,1881,3538161,60100,quiescent
/dev/fakeUSB0,469,482,483,471,1905,3629025,60120,quiescent
/dev/fakeUSB0,460,459,464,469,1852,3429904,60140,quiescent
/dev/fakeUSB0,460,474,484,478,1896,3594816,60160,quiescent
/dev/fakeUSB0,455,457,463,471,1846,3407716,60180,quiescent
/dev/fakeUSB0,460,477,484,473,1894,3587236,60200,quiescent
/dev/fakeUSB0,463,464,464,460,1851,3426201,60220,quiescent
/dev/fakeUSB0,473,481,483,469,1906,3632836,60240,quiescent
/dev/fakeUSB0,467,469,464,468,1868,3489424,60260,quiescent
/dev/fakeUSB0,475,476,481,473,1905,3629025,60280,quiescent
/dev/fakeUSB0,469,468,469,463,1869,3493161,60300,quiescent
/dev/fakeUSB0,478,480,478,474,1910,3648100,60320,quiescent
/dev/fakeUSB0,479,472,467,463,1881,3538161,60340,quiescent
/dev/fakeUSB0,473,482,476,474,1905,3629025,60360,quiescent
/dev/fakeUSB0,469,472,467,467,1875,3515625,60380,quiescent
/dev/fakeUSB0,468,475,472,468,1883,3545689,60400,quiescent
/dev/fakeUSB0,470,463,473,466,1872,3504384,60420,quiescent
/dev/fakeUSB0,460,473,473,468,1874,3511876,60440,quiescent
/dev/fakeUSB0,467,470,478,468,1883,3545689,60460,quiescent
/dev/fakeUSB0,467,469,473,469,1878,3526884,60480,quiescent
/dev/fakeUSB0,465,469,475,459,1868,3489424,60500,quiescent
/dev/fakeUSB0,468,468,463,458,1857,3448449,60520,quiescent
/dev/fakeUSB0,476,479,473,467,1895,3591025,60540,quiescent
/dev/fakeUSB0,471,468,460,473,1872,3504384,60560,quiescent
/dev/fakeUSB0,475,479,472,470,1896,3594816,60580,quiescent
/dev/fakeUSB0,468,469,470,467,1874,3511876,60600,quiescent
/dev/fakeUSB0,471,476,478,475,1900,3610000,60620,quiescent
/dev/fakeUSB0,464,455,465,467,1851,3426201,60640,quiescent
/dev/fakeUSB0,469,477,483,469,1898,3602404,60660,quiescent
/dev/fakeUSB0,465,462,466,459,1852,3429904,60680,quiescent
/dev/fakeUSB0,475,473,486,475,1909,3644281,60700,quiescent
/dev/fakeUSB0,466,466,474,458,1864,3474496,60720,quiescent
/dev/fakeUSB0,476,480,475,471,1902,3617604,60740,quiescent
/dev/fakeUSB0,474,465,465,471,1875,3515625,60760,quiescent
/dev/fakeUSB0,465,479,475,475,1894,3587236,60780,quiescent
/dev/fakeUSB0,468,464,469,469,1870,3496900,60800,quiescent
/dev/fakeUSB0,468,477,475,475,1895,3591025,60820,quiescent
/dev/fakeUSB0,468,468,470,467,1873,3508129,60840,quiescent
/dev/fakeUSB0,468,480,476,468,1892,3579664,60860,quiescent
/dev/fakeUSB0,465,468,473,471,1877,3523129,60880,quiescent
/dev/fakeUSB0,465,476,475,468,1884,3549456,60900,quiescent
/dev/fakeUSB0,461,471,470,471,1873,3508129,60920,quiescent
/dev/fakeUSB0,468,476,471,476,1891,3575881,60940,quiescent
/dev/fakeUSB0,470,472,466,469,1877,3523129,60960,quiescent
/dev/fakeUSB0,473,467,474,462,1876,3519376,60980,quiescent
/dev/fakeUSB0,473,482,480,472,1907,3636649,61000,quiescent
/dev/fakeUSB0,474,465,471,465,1875,3515625,61020,quiescent
/dev/fakeUSB0,472,478,486,471,1907,3636649,61040,quiescent
/dev/fakeUSB0,468,473,467,463,1871,3500641,61060,quiescent
/dev/fakeUSB0,474,477,484,470,1905,3629025,61080,quiescent
/dev/fakeUSB0,465,466,467,468,1866,3481956,61100,quiescent
/dev/fakeUSB0,472,484,480,476,1912,3655744,61120,quiescent
/dev/fakeUSB0,474,455,467,466,1862,3467044,61140,quiescent
/dev/fakeUSB0,468,476,479,472,1895,3591025,61160,quiescent
/dev/fakeUSB0,468,459,456,462,1845,3404025,61180,quiescent
/dev/fakeUSB0,467,476,482,473,1898,3602404,61200,quiescent
/dev/fakeUSB0,464,456,467,471,1858,3452164,61220,quiescent
/dev/fakeUSB0,472,473,474,471,1890,3572100,61240,quiescent
/dev/fakeUSB0,472,459,467,468,1866,3481956,61260,quiescent
/dev/fakeUSB0,470,475,480,472,1897,3598609,61280,quiescent
/dev/fakeUSB0,473,472,467,467,1879,3530641,61300,quiescent
/dev/fakeUSB0,477,478,476,465,1896,3594816,61320,quiescent
/dev/fakeUSB0,468,465,472,470,1875,3515625,61340,quiescent
/dev/fakeUSB0,465,469,469,461,1864,3474496,61360,quiescent
/dev/fakeUSB0,470,471,476,469,1886,3556996,61380,quiescent
/dev/fakeUSB0,468,475,484,466,1893,3583449,61400,quiescent
/dev/fakeUSB0,466,470,481,469,1886,3556996,61420,quiescent
/dev/fakeUSB0,467,463,472,472,1874,3511876,61440,quiescent
/dev/fakeUSB0,468,468,476,473,1885,3553225,61460,quiescent
/dev/fakeUSB0,468,467,474,465,1874,3511876,61480,quiescent
/dev/fakeUSB0,463,471,483,470,1887,3560769,61500,quiescent
/dev/fakeUSB0,468,471,461,467,1867,3485689,61520,quiescent
/dev/fakeUSB0,479,477,473,471,1900,3610000,61540,quiescent
/dev/fakeUSB0,476,468,448,467,1859,3455881,61560,quiescent
/dev/fakeUSB0,476,477,481,475,1909,3644281,61580,quiescent
/dev/fakeUSB0,465,470,463,460,1858,3452164,61600,quiescent
/dev/fakeUSB0,469,481,484,470,1904,3625216,61620,quiescent
/dev/fakeUSB0,467,462,466,461,1856,3444736,61640,quiescent
/dev/fakeUSB0,469,476,478,470,1893,3583449,61660,quiescent
/dev/fakeUSB0,465,455,470,471,1861,3463321,61680,quiescent
/dev/fakeUSB0,478,479,484,476,1917,3674889,61700,quiescent
/dev/fakeUSB0,468,464,466,465,1863,3470769,61720,quiescent
/dev/fakeUSB0,477,480,474,473,1904,3625216,61740,quiescent
/dev/fakeUSB0,468,462,463,475,1868,3489424,61760,quiescent
/dev/fakeUSB0,473,479,478,473,1903,3621409,61780,quiescent
/dev/fakeUSB0,469,467,468,471,1875,3515625,61800,quiescent
/dev/fakeUSB0,478,474,476,476,1904,3625216,61820,quiescent
/dev/fakeUSB0,468,464,463,475,1870,3496900,61840,quiescent
/dev/fakeUSB0,476,473,471,474,1894,3587236,61860,quiescent
/dev/fakeUSB0,464,467,468,473,1872,3504384,61880,quiescent
/dev/fakeUSB0,465,463,472,464,1864,3474496,61900,quiescent
/dev/fakeUSB0,469,467,469,466,1871,3500641,61920,quiescent
/dev/fakeUSB0,464,472,474,460,1870,3496900,61940,quiescent
/dev/fakeUSB0,461,474,476,469,1880,3534400,61960,quiescent
/dev/fakeUSB0,463,465,468,468,1864,3474496,61980,quiescent
/dev/fakeUSB0,468,477,476,471,1892,3579664,62000,quiescent
/dev/fakeUSB0,468,463,463,475,1869,3493161,62020,quiescent
/dev/fakeUSB0,471,472,483,476,1902,3617604,62040,quiescent
/dev/fakeUSB0,465,469,465,466,1865,3478225,62060,quiescent
/dev/fakeUSB0,468,477,476,473,1894,3587236,62080,quiescent
/dev/fakeUSB0,464,467,470,442,1843,3396649,62100,quiescent
/dev/fakeUSB0,467,481,483,473,1904,3625216,62120,quiescent
/dev/fakeUSB0,468,466,465,462,1861,3463321,62140,quiescent
/dev/fakeUSB0,468,477,471,477,1893,3583449,62160,quiescent
/dev/fakeUSB0,461,465,464,463,1853,3433609,62180,quiescent
/dev/fakeUSB0,475,476,485,466,1902,3617604,62200,quiescent
/dev/fakeUSB0,464,468,469,470,1871,3500641,62220,quiescent
/dev/fakeUSB0,474,476,484,475,1909,3644281,62240,quiescent
/dev/fakeUSB0,467,460,460,463,1850,3422500,62260,quiescent
/dev/fakeUSB0,469,473,469,472,1883,3545689,62280,quiescent
/dev/fakeUSB0,459,458,467,464,1848,3415104,62300,quiescent
/dev/fakeUSB0,467,472,486,473,1898,3602404,62320,quiescent
/dev/fakeUSB0,470,470,467,463,1870,3496900,62340,quiescent
/dev/fakeUSB0,474,471,476,465,1886,3556996,62360,quiescent
/dev/fakeUSB0,473,469,476,468,1886,3556996,62380,quiescent
/dev/fakeUSB0,475,474,477,468,1894,3587236,62400,quiescent
/dev/fakeUSB0,469,479,479,465,1892,3579664,62420,quiescent
/dev/fakeUSB0,471,471,470,471,1883,3545689,62440,quiescent
/dev/fakeUSB0,464,468,467,466,1865,3478225,62460,quiescent
/dev/fakeUSB0,458,457,461,465,1841,3389281,62480,quiescent
/dev/fakeUSB0,470,462,472,470,1874,3511876,62500,quiescent
/dev/fakeUSB0,461,455,468,463,1847,3411409,62520,quiescent
/dev/fakeUSB0,470,474,472,473,1889,3568321,62540,quiescent
/dev/fakeUSB0,463,462,462,466,1853,3433609,62560,quiescent
/dev/fakeUSB0,470,486,481,468,1905,3629025,62580,quiescent
/dev/fakeUSB0,469,468,471,464,1872,3504384,62600,quiescent
/dev/fakeUSB0,477,480,483,473,1913,3659569,62620,quiescent
/dev/fakeUSB0,465,471,472,463,1871,3500641,62640,quiescent
/dev/fakeUSB0,470,483,476,473,1902,3617604,62660,quiescent
/dev/fakeUSB0,465,466,476,463,1870,3496900,62680,quiescent
/dev/fakeUSB0,468,483,486,467,1904,3625216,62700,quiescent
/dev/fakeUSB0,463,462,461,464,1850,3422500,62720,quiescent
/dev/fakeUSB0,467,472,476,472,1887,3560769,62740,quiescent
/dev/fakeUSB0,461,458,461,468,1848,3415104,62760,quiescent
/dev/fakeUSB0,466,473,472,472,1883,3545689,62780,quiescent
/dev/fakeUSB0,468,463,475,474,1880,3534400,62800,quiescent
/dev/fakeUSB0,475,481,474,470,1900,3610000,62820,quiescent
/dev/fakeUSB0,468,474,475,471,1888,3564544,62840,quiescent
/dev/fakeUSB0,474,479,476,462,1891,3575881,62860,quiescent
/dev/fakeUSB0,475,472,481,473,1901,3613801,62880,quiescent
/dev/fakeUSB0,481,473,469,470,1893,3583449,62900,quiescent
/dev/fakeUSB0,455,470,474,473,1872,3504384,62920,quiescent
/dev/fakeUSB0,465,461,467,466,1859,3455881,62940,quiescent
/dev/fakeUSB0,465,468,478,467,1878,3526884,62960,quiescent
/dev/fakeUSB0,464,461,462,464,1851,3426201,62980,quiescent
/dev/fakeUSB0,464,476,484,478,1902,3617604,63000,quiescent
/dev/fakeUSB0,472,473,467,465,1877,3523129,63020,quiescent
/dev/fakeUSB0,475,479,478,473,1905,3629025,63040,quiescent
/dev/fakeUSB0,468,465,458,457,1848,3415104,63060,quiescent
/dev/fakeUSB0,469,484,474,469,1896,3594816,63080,quiescent
/dev/fakeUSB0,470,464,459,463,1856,3444736,63100,quiescent
/dev/fakeUSB0,464,479,476,474,1893,3583449,63120,quiescent
/dev/fakeUSB0,463,457,454,463,1837,3374569,63140,quiescent
/dev/fakeUSB0,463,477,469,468,1877,3523129,63160,quiescent
/dev/fakeUSB0,468,460,468,466,1862,3467044,63180,quiescent
/dev/fakeUSB0,464,470,477,475,1886,3556996,63200,quiescent
/dev/fakeUSB0,468,465,465,468,1866,3481956,63220,quiescent
/dev/fakeUSB0,469,474,478,476,1897,3598609,63240,quiescent
/dev/fakeUSB0,468,468,473,475,1884,3549456,63260,quiescent
/dev/fakeUSB0,468,473,479,474,1894,3587236,63280,quiescent
/dev/fakeUSB0,469,468,466,471,1874,3511876,63300,quiescent
/dev/fakeUSB0,471,468,470,462,1871,3500641,63320,quiescent
/dev/fakeUSB0,466,466,468,461,1861,3463321,63340,quiescent
/dev/fakeUSB0,466,474,471,468,1879,3530641,63360,quiescent
/dev/fakeUSB0,468,474,474,470,1886,3556996,63380,quiescent
/dev/fakeUSB0,471,476,468,467,1882,3541924,63400,quiescent
/dev/fakeUSB0,462,480,471,473,1886,3556996,63420,quiescent
/dev/fakeUSB0,468,464,464,466,1862,3467044,63440,quiescent
/dev/fakeUSB0,469,452,472,472,1865,3478225,63460,quiescent
/dev/fakeUSB0,465,461,465,467,1858,3452164,63480,quiescent
/dev/fakeUSB0,476,475,475,478,1904,3625216,63500,quiescent
/dev/fakeUSB0,475,467,464,460,1866,3481956,63520,quiescent
/dev/fakeUSB0,474,476,476,478,1904,3625216,63540,quiescent
/dev/fakeUSB0,463,460,466,472,1861,3463321,63560,quiescent
/dev/fakeUSB0,467,477,492,470,1906,3632836,63580,quiescent
/dev/fakeUSB0,460,460,468,463,1851,3426201,63600,quiescent
/dev/fakeUSB0,469,474,477,470,1890,3572100,63620,quiescent
/dev/fakeUSB0,460,466,458,461,1845,3404025,63640,quiescent
/dev/fakeUSB0,472,479,488,473,1912,3655744,63660,quiescent
/dev/fakeUSB0,465,463,460,473,1861,3463321,63680,quiescent
/dev/fakeUSB0,477,480,482,474,1913,3659569,63700,quiescent
/dev/fakeUSB0,465,468,470,470,1873,3508129,63720,quiescent
/dev/fakeUSB0,466,476,471,475,1888,3564544,63740,quiescent
/dev/fakeUSB0,461,463,470,467,1861,3463321,63760,quiescent
/dev/fakeUSB0,466,468,476,472,1882,3541924,63780,quiescent
/dev/fakeUSB0,464,464,467,471,1866,3481956,63800,quiescent
/dev/fakeUSB0,469,474,476,474,1893,3583449,63820,quiescent
/dev/fakeUSB0,471,473,471,479,1894,3587236,63840,quiescent
/dev/fakeUSB0,470,475,476,472,1893,3583449,63860,quiescent
/dev/fakeUSB0,469,473,464,476,1882,3541924,63880,quiescent
/dev/fakeUSB0,469,461,463,465,1858,3452164,63900,quiescent
/dev/fakeUSB0,468,474,477,473,1892,3579664,63920,quiescent
/dev/fakeUSB0,472,467,469,465,1873,3508129,63940,quiescent
/dev/fakeUSB0,469,472,483,468,1892,3579664,63960,quiescent
/dev/fakeUSB0,463,464,468,460,1855,3441025,63980,quiescent
/dev/fakeUSB0,467,482,468,476,1893,3583449,64000,quiescent
/dev/fakeUSB0,469,472,476,472,1889,3568321,64020,quiescent
/dev/fakeUSB0,472,483,489,472,1916,3671056,64040,quiescent
/dev/fakeUSB0,468,469,464,464,1865,3478225,64060,quiescent
/dev/fakeUSB0,471,476,478,475,1900,3610000,64080,quiescent
/dev/fakeUSB0,468,463,468,471,1870,3496900,64100,quiescent
/dev/fakeUSB0,471,476,477,467,1891,3575881,64120,quiescent
/dev/fakeUSB0,463,456,464,460,1843,3396649,64140,quiescent
/dev/fakeUSB0,468,476,485,475,1904,3625216,64160,quiescent
/dev/fakeUSB0,460,465,466,473,1864,3474496,64180,quiescent
/dev/fakeUSB0,471,475,476,478,1900,3610000,64200,quiescent
/dev/fakeUSB0,467,471,467,465,1870,3496900,64220,quiescent
/dev/fakeUSB0,471,472,475,467,1885,3553225,64240,quiescent
/dev/fakeUSB0,467,468,471,465,1871,3500641,64260,quiescent
/dev/fakeUSB0,471,469,471,463,1874,3511876,64280,quiescent
/dev/fakeUSB0,468,465,473,468,1874,3511876,64300,quiescent
/dev/fakeUSB0,475,478,466,471,1890,3572100,64320,quiescent
/dev/fakeUSB0,464,479,468,468,1879,3530641,64340,quiescent
/dev/fakeUSB0,466,476,474,471,1887,3560769,64360,quiescent
/dev/fakeUSB0,475,469,475,467,1886,3556996,64380,quiescent
/dev/fakeUSB0,469,463,463,469,1864,3474496,64400,quiescent
/dev/fakeUSB0,464,468,479,474,1885,3553225,64420,quiescent
/dev/fakeUSB0,461,457,467,465,1850,3422500,64440,quiescent
/dev/fakeUSB0,471,475,475,469,1890,3572100,64460,quiescent
/dev/fakeUSB0,465,462,461,473,1861,3463321,64480,quiescent
/dev/fakeUSB0,470,480,476,476,1902,3617604,64500,quiescent
/dev/fakeUSB0,468,468,461,454,1851,3426201,64520,quiescent
/dev/fakeUSB0,475,487,478,471,1911,3651921,64540,quiescent
/dev/fakeUSB0,470,469,453,458,1850,3422500,64560,quiescent
/dev/fakeUSB0,475,477,471,477,1900,3610000,64580,quiescent
/dev/fakeUSB0,468,464,462,466,1860,3459600,64600,quiescent
/dev/fakeUSB0,472,476,480,468,1896,3594816,64620,quiescent
/dev/fakeUSB0,466,464,457,462,1849,3418801,64640,quiescent
/dev/fakeUSB0,471,471,476,472,1890,3572100,64660,quiescent
/dev/fakeUSB0,463,459,465,459,1846,3407716,64680,quiescent
/dev/fakeUSB0,472,470,473,463,1878,3526884,64700,quiescent
/dev/fakeUSB0,468,465,457,469,1859,3455881,64720,quiescent
/dev/fakeUSB0,469,477,479,480,1905,3629025,64740,quiescent
/dev/fakeUSB0,466,467,461,472,1866,3481956,64760,quiescent
/dev/fakeUSB0,469,473,469,472,1883,3545689,64780,quiescent
/dev/fakeUSB0,472,477,471,475,1895,3591025,64800,quiescent
/dev/fakeUSB0,469,475,472,475,1891,3575881,64820,quiescent
/dev/fakeUSB0,467,473,464,468,1872,3504384,64840,quiescent
/dev/fakeUSB0,470,470,460,460,1860,3459600,64860,quiescent
/dev/fakeUSB0,472,476,468,468,1884,3549456,64880,quiescent
/dev/fakeUSB0,469,464,462,459,1854,3437316,64900,quiescent
/dev/fakeUSB0,466,480,468,468,1882,3541924,64920,quiescent
/dev/fakeUSB0,465,466,460,462,1853,3433609,64940,quiescent
/dev/fakeUSB0,465,477,481,470,1893,3583449,64960,quiescent
/dev/fakeUSB0,462,466,467,471,1866,3481956,64980,quiescent
/dev/fakeUSB0,475,479,484,478,1916,3671056,65000,quiescent
/dev/fakeUSB0,463,464,465,473,1865,3478225,65020,quiescent
/dev/fakeUSB0,476,479,486,482,1923,3697929,65040,quiescent
/dev/fakeUSB0,465,469,461,474,1869,3493161,65060,quiescent
/dev/fakeUSB0,468,480,475,476,1899,3606201,65080,quiescent
/dev/fakeUSB0,467,468,462,467,1864,3474496,65100,quiescent
/dev/fakeUSB0,470,477,474,468,1889,3568321,65120,quiescent
/dev/fakeUSB0,473,462,460,465,1860,3459600,65140,quiescent
/dev/fakeUSB0,468,480,482,469,1899,3606201,65160,quiescent
/dev/fakeUSB0,459,471,465,468,1863,3470769,65180,quiescent
/dev/fakeUSB0,463,476,483,471,1893,3583449,65200,quiescent
/dev/fakeUSB0,461,468,460,464,1853,3433609,65220,quiescent
/dev/fakeUSB0,465,471,478,467,1881,3538161,65240,quiescent
/dev/fakeUSB0,470,468,465,470,1873,3508129,65260,quiescent
/dev/fakeUSB0,453,476,470,472,1871,3500641,65280,quiescent
/dev/fakeUSB0,466,471,471,469,1877,3523129,65300,quiescent
/dev/fakeUSB0,469,468,476,471,1884,3549456,65320,quiescent
/dev/fakeUSB0,475,467,468,472,1882,3541924,65340,quiescent
/dev/fakeUSB0,467,469,467,467,1870,3496900,65360,quiescent
/dev/fakeUSB0,478,473,472,472,1895,3591025,65380,quiescent
/dev/fakeUSB0,470,463,465,460,1858,3452164,65400,quiescent
/dev/fakeUSB0,476,480,480,474,1910,3648100,65420,quiescent
/dev/fakeUSB0,463,468,464,466,1861,3463321,65440,quiescent
/dev/fakeUSB0,466,473,480,469,1888,3564544,65460,quiescent
/dev/fakeUSB0,461,467,461,465,1854,3437316,65480,quiescent
/dev/fakeUSB0,469,472,476,468,1885,3553225,65500,quiescent
/dev/fakeUSB0,456,463,466,469,1854,3437316,65520,quiescent
/dev/fakeUSB0,472,479,480,471,1902,3617604,65540,quiescent
/dev/fakeUSB0,466,463,464,466,1859,3455881,65560,quiescent
/dev/fakeUSB0,474,484,472,477,1907,3636649,65580,quiescent
/dev/fakeUSB0,469,464,462,469,1864,3474496,65600,quiescent
/dev/fakeUSB0,476,477,474,468,1895,3591025,65620,quiescent
/dev/fakeUSB0,471,459,470,466,1866,3481956,65640,quiescent
/dev/fakeUSB0,473,477,476,471,1897,3598609,65660,quiescent
/dev/fakeUSB0,465,465,464,473,1867,3485689,65680,quiescent
/dev/fakeUSB0,467,472,473,471,1883,3545689,65700,quiescent
/dev/fakeUSB0,462,464,467,472,1865,3478225,65720,quiescent
/dev/fakeUSB0,467,470,483,470,1890,3572100,65740,quiescent
/dev/fakeUSB0,468,467,469,467,1871,3500641,65760,quiescent
/dev/fakeUSB0,471,466,472,468,1877,3523129,65780,quiescent
/dev/fakeUSB0,471,470,468,464,1873,3508129,65800,quiescent
/dev/fakeUSB0,472,474,472,466,1884,3549456,65820,quiescent
/dev/fakeUSB0,474,474,474,469,1891,3575881,65840,quiescent
/dev/fakeUSB0,475,474,468,468,1885,3553225,65860,quiescent
/dev/fakeUSB0,477,481,476,471,1905,3629025,65880,quiescent
/dev/fakeUSB0,469,461,465,466,1861,3463321,65900,quiescent
/dev/fakeUSB0,468,477,477,468,1890,3572100,65920,quiescent
/dev/fakeUSB0,468,464,460,463,1855,3441025,65940,quiescent
/dev/fakeUSB0,471,484,481,468,1904,3625216,65960,quiescent
/dev/fakeUSB0,470,458,462,461,1851,3426201,65980,quiescent
/dev/fakeUSB0,471,479,478,472,1900,3610000,66000,quiescent
/dev/fakeUSB0,470,462,455,466,1853,3433609,66020,quiescent
/dev/fakeUSB0,471,478,477,468,1894,3587236,66040,quiescent
/dev/fakeUSB0,469,455,469,474,1867,3485689,66060,quiescent
/dev/fakeUSB0,476,477,482,479,1914,3663396,66080,quiescent
/dev/fakeUSB0,470,473,458,466,1867,3485689,66100,quiescent
/dev/fakeUSB0,471,478,479,477,1905,3629025,66120,quiescent
/dev/fakeUSB0,463,467,459,468,1857,3448449,66140,quiescent
/dev/fakeUSB0,469,475,470,473,1887,3560769,66160,quiescent
/dev/fakeUSB0,468,471,469,463,1871,3500641,66180,quiescent
/dev/fakeUSB0,470,466,469,466,1871,3500641,66200,quiescent
/dev/fakeUSB0,465,468,474,466,1873,3508129,66220,quiescent
/dev/fakeUSB0,465,472,475,470,1882,3541924,66240,quiescent
/dev/fakeUSB0,463,471,473,462,1869,3493161,66260,quiescent
/dev/fakeUSB0,462,467,471,461,1861,3463321,66280,quiescent
/dev/fakeUSB0,464,468,479,465,1876,3519376,66300,quiescent
/dev/fakeUSB0,473,465,466,463,1867,3485689,66320,quiescent
/dev/fakeUSB0,475,472,471,462,1880,3534400,66340,quiescent
/dev/fakeUSB0,476,471,456,468,1871,3500641,66360,quiescent
/dev/fakeUSB0,476,477,454,466,1873,3508129,66380,quiescent
/dev/fakeUSB0,470,468,467,469,1874,3511876,66400,quiescent
/dev/fakeUSB0,472,477,473,472,1894,3587236,66420,quiescent
/dev/fakeUSB0,466,465,460,460,1851,3426201,66440,quiescent
/dev/fakeUSB0,475,478,484,468,1905,3629025,66460,quiescent
/dev/fakeUSB0,465,459,467,469,1860,3459600,66480,quiescent
/dev/fakeUSB0,469,476,484,468,1897,3598609,66500,quiescent
/dev/fakeUSB0,465,461,467,460,1853,3433609,66520,quiescent
/dev/fakeUSB0,472,472,479,469,1892,3579664,66540,quiescent
/dev/fakeUSB0,461,464,454,447,1826,3334276,66560,quiescent
/dev/fakeUSB0,471,480,472,476,1899,3606201,66580,quiescent
/dev/fakeUSB0,465,462,460,465,1852,3429904,66600,quiescent
/dev/fakeUSB0,470,480,472,473,1895,3591025,66620,quiescent
/dev/fakeUSB0,472,467,465,464,1868,3489424,66640,quiescent
/dev/fakeUSB0,471,476,477,469,1893,3583449,66660,quiescent
/dev/fakeUSB0,464,461,464,470,1859,3455881,66680,quiescent
/dev/fakeUSB0,465,479,472,467,1883,3545689,66700,quiescent
/dev/fakeUSB0,462,468,468,470,1868,3489424,66720,quiescent
/dev/fakeUSB0,460,470,474,473,1877,3523129,66740,quiescent
/dev/fakeUSB0,465,474,475,462,1876,3519376,66760,quiescent
/dev/fakeUSB0,472,470,475,469,1886,3556996,66780,quiescent
/dev/fakeUSB0,471,472,470,468,1881,3538161,66800,quiescent
/dev/fakeUSB0,468,462,469,473,1872,3504384,66820,quiescent
/dev/fakeUSB0,476,473,476,471,1896,3594816,66840,quiescent
/dev/fakeUSB0,469,470,463,473,1875,3515625,66860,quiescent
/dev/fakeUSB0,467,475,475,473,1890,3572100,66880,quiescent
/dev/fakeUSB0,470,467,459,474,1870,3496900,66900,quiescent
/dev/fakeUSB0,465,478,470,469,1882,3541924,66920,quiescent
/dev/fakeUSB0,469,458,464,472,1863,3470769,66940,quiescent
/dev/fakeUSB0,469,476,476,463,1884,3549456,66960,quiescent
/dev/fakeUSB0,460,468,457,466,1851,3426201,66980,quiescent
/dev/fakeUSB0,470,479,480,477,1906,3632836,67000,quiescent
/dev/fakeUSB0,469,460,461,476,1866,3481956,67020,quiescent
/dev/fakeUSB0,476,487,475,480,1918,3678724,67040,quiescent
/dev/fakeUSB0,478,469,470,464,1881,3538161,67060,quiescent
/dev/fakeUSB0,475,484,482,474,1915,3667225,67080,quiescent
/dev/fakeUSB0,474,472,464,463,1873,3508129,67100,quiescent
/dev/fakeUSB0,475,472,472,472,1891,3575881,67120,quiescent
/dev/fakeUSB0,464,460,468,470,1862,3467044,67140,quiescent
/dev/fakeUSB0,466,468,470,476,1880,3534400,67160,quiescent
/dev/fakeUSB0,466,469,465,464,1864,3474496,67180,quiescent
/dev/fakeUSB0,468,474,478,473,1893,3583449,67200,quiescent
/dev/fakeUSB0,473,472,471,471,1887,3560769,67220,quiescent
/dev/fakeUSB0,476,480,472,464,1892,3579664,67240,quiescent
/dev/fakeUSB0,471,476,476,472,1895,3591025,67260,quiescent
/dev/fakeUSB0,468,472,473,469,1882,3541924,67280,quiescent
/dev/fakeUSB0,472,468,463,464,1867,3485689,67300,quiescent
/dev/fakeUSB0,475,462,466,463,1866,3481956,67320,quiescent
/dev/fakeUSB0,472,471,474,475,1892,3579664,67340,quiescent
/dev/fakeUSB0,473,463,464,465,1865,3478225,67360,quiescent
/dev/fakeUSB0,471,469,474,472,1886,3556996,67380,quiescent
/dev/fakeUSB0,466,461,460,470,1857,3448449,67400,quiescent
/dev/fakeUSB0,463,476,489,475,1903,3621409,67420,quiescent
/dev/fakeUSB0,462,471,470,468,1871,3500641,67440,quiescent
/dev/fakeUSB0,473,479,477,476,1905,3629025,67460,quiescent
/dev/fakeUSB0,474,468,457,457,1856,3444736,67480,quiescent
/dev/fakeUSB0,468,476,477,467,1888,3564544,67500,quiescent
/dev/fakeUSB0,471,465,460,468,1864,3474496,67520,quiescent
/dev/fakeUSB0,478,477,484,472,1911,3651921,67540,quiescent
/dev/fakeUSB0,463,464,468,469,1864,3474496,67560,quiescent
/dev/fakeUSB0,464,472,476,478,1890,3572100,67580,quiescent
/dev/fakeUSB0,454,463,464,468,1849,3418801,67600,quiescent
/dev/fakeUSB0,460,476,475,472,1883,3545689,67620,quiescent
/dev/fakeUSB0,461,461,471,461,1854,3437316,67640,quiescent
/dev/fakeUSB0,471,477,478,479,1905,3629025,67660,quiescent
/dev/fakeUSB0,473,460,467,464,1864,3474496,67680,quiescent
/dev/fakeUSB0,475,472,465,468,1880,3534400,67700,quiescent
/dev/fakeUSB0,452,471,473,472,1868,3489424,67720,quiescent
/dev/fakeUSB0,452,479,473,469,1873,3508129,67740,quiescent
/dev/fakeUSB0,471,475,472,472,1890,3572100,67760,quiescent
/dev/fakeUSB0,468,467,460,468,1863,3470769,67780,quiescent
/dev/fakeUSB0,468,471,470,466,1875,3515625,67800,quiescent
/dev/fakeUSB0,465,467,465,471,1868,3489424,67820,quiescent
/dev/fakeUSB0,468,468,475,476,1887,3560769,67840,quiescent
/dev/fakeUSB0,464,462,466,465,1857,3448449,67860,quiescent
/dev/fakeUSB0,469,466,481,465,1881,3538161,67880,quiescent
/dev/fakeUSB0,460,464,456,460,1840,3385600,67900,quiescent
/dev/fakeUSB0,469,484,480,472,1905,3629025,67920,quiescent
/dev/fakeUSB0,461,466,460,465,1852,3429904,67940,quiescent
/dev/fakeUSB0,464,477,486,468,1895,3591025,67960,quiescent
/dev/fakeUSB0,464,463,468,466,1861,3463321,67980,quiescent
/dev/fakeUSB0,468,473,474,478,1893,3583449,68000,quiescent
/dev/fakeUSB0,463,457,467,463,1850,3422500,68020,quiescent
/dev/fakeUSB0,468,473,481,476,1898,3602404,68040,quiescent
/dev/fakeUSB0,464,468,466,467,1865,3478225,68060,quiescent
/dev/fakeUSB0,472,480,476,478,1906,3632836,68080,quiescent
/dev/fakeUSB0,468,472,466,464,1870,3496900,68100,quiescent
/dev/fakeUSB0,471,478,476,466,1891,3575881,68120,quiescent
/dev/fakeUSB0,460,460,471,469,1860,3459600,68140,quiescent
/dev/fakeUSB0,470,468,475,469,1882,3541924,68160,quiescent
/dev/fakeUSB0,473,461,473,468,1875,3515625,68180,quiescent
/dev/fakeUSB0,470,474,471,468,1883,3545689,68200,quiescent
/dev/fakeUSB0,466,465,467,471,1869,3493161,68220,quiescent
/dev/fakeUSB0,463,456,461,469,1849,3418801,68240,quiescent
/dev/fakeUSB0,467,474,466,476,1883,3545689,68260,quiescent
/dev/fakeUSB0,465,467,462,464,1858,3452164,68280,quiescent
/dev/fakeUSB0,472,467,469,471,1879,3530641,68300,quiescent
/dev/fakeUSB0,474,464,462,467,1867,3485689,68320,quiescent
/dev/fakeUSB0,477,470,473,472,1892,3579664,68340,quiescent
/dev/fakeUSB0,469,463,457,463,1852,3429904,68360,quiescent
/dev/fakeUSB0,471,471,479,473,1894,3587236,68380,quiescent
/dev/fakeUSB0,466,460,465,470,1861,3463321,68400,quiescent
/dev/fakeUSB0,468,477,472,472,1889,3568321,68420,quiescent
/dev/fakeUSB0,468,464,469,455,1856,3444736,68440,quiescent
/dev/fakeUSB0,469,471,478,473,1891,3575881,68460,quiescent
/dev/fakeUSB0,464,458,458,465,1845,3404025,68480,quiescent
/dev/fakeUSB0,470,474,481,475,1900,3610000,68500,quiescent
/dev/fakeUSB0,462,466,465,474,1867,3485689,68520,quiescent
/dev/fakeUSB0,472,478,483,480,1913,3659569,68540,quiescent
/dev/fakeUSB0,462,465,468,466,1861,3463321,68560,quiescent
/dev/fakeUSB0,472,480,481,475,1908,3640464,68580,quiescent
/dev/fakeUSB0,464,473,468,468,1873,3508129,68600,quiescent
/dev/fakeUSB0,473,471,479,465,1888,3564544,68620,quiescent
/dev/fakeUSB0,466,468,467,467,1868,3489424,68640,quiescent
/dev/fakeUSB0,468,476,469,470,1883,3545689,68660,quiescent
/dev/fakeUSB0,466,463,476,465,1870,3496900,68680,quiescent
/dev/fakeUSB0,466,474,471,468,1879,3530641,68700,quiescent
/dev/fakeUSB0,461,468,466,468,1863,3470769,68720,quiescent
/dev/fakeUSB0,468,465,469,462,1864,3474496,68740,quiescent
/dev/fakeUSB0,476,465,475,468,1884,3549456,68760,quiescent
/dev/fakeUSB0,468,472,464,462,1866,3481956,68780,quiescent
/dev/fakeUSB0,475,476,471,471,1893,3583449,68800,quiescent
/dev/fakeUSB0,469,462,461,467,1859,3455881,68820,quiescent
/dev/fakeUSB0,473,467,474,464,1878,3526884,68840,quiescent
/dev/fakeUSB0,471,466,468,470,1875,3515625,68860,quiescent
/dev/fakeUSB0,466,477,478,468,1889,3568321,68880,quiescent
/dev/fakeUSB0,464,458,468,468,1858,3452164,68900,quiescent
/dev/fakeUSB0,469,477,475,476,1897,3598609,68920,quiescent
/dev/fakeUSB0,463,461,460,469,1853,3433609,68940,quiescent
/dev/fakeUSB0,465,479,479,476,1899,3606201,68960,quiescent
/dev/fakeUSB0,468,467,462,473,1870,3496900,68980,quiescent
/dev/fakeUSB0,477,484,479,475,1915,3667225,69000,quiescent
/dev/fakeUSB0,471,469,467,466,1873,3508129,69020,quiescent
/dev/fakeUSB0,478,472,475,472,1897,3598609,69040,quiescent
/dev/fakeUSB0,472,460,459,463,1854,3437316,69060,quiescent
/dev/fakeUSB0,471,469,481,471,1892,3579664,69080,quiescent
/dev/fakeUSB0,460,460,465,464,1849,3418801,69100,quiescent
/dev/fakeUSB0,463,476,480,471,1890,3572100,69120,quiescent
/dev/fakeUSB0,463,463,468,473,1867,3485689,69140,quiescent
/dev/fakeUSB0,467,484,489,476,1916,3671056,69160,quiescent
/dev/fakeUSB0,475,467,473,468,1883,3545689,69180,quiescent
/dev/fakeUSB0,470,468,473,476,1887,3560769,69200,quiescent
/dev/fakeUSB0,467,472,472,477,1888,3564544,69220,quiescent
/dev/fakeUSB0,467,473,475,468,1883,3545689,69240,quiescent
/dev/fakeUSB0,455,466,483,468,1872,3504384,69260,quiescent
/dev/fakeUSB0,475,474,472,463,1884,3549456,69280,quiescent
/dev/fakeUSB0,474,480,476,443,1873,3508129,69300,quiescent
/dev/fakeUSB0,469,469,461,464,1863,3470769,69320,quiescent
/dev/fakeUSB0,471,476,483,469,1899,3606201,69340,quiescent
/dev/fakeUSB0,464,468,460,467,1859,3455881,69360,quiescent
/dev/fakeUSB0,469,477,477,469,1892,3579664,69380,quiescent
/dev/fakeUSB0,466,463,468,475,1872,3504384,69400,quiescent
/dev/fakeUSB0,471,478,472,469,1890,3572100,69420,quiescent
/dev/fakeUSB0,465,461,459,471,1856,3444736,69440,quiescent
/dev/fakeUSB0,468,475,484,468,1895,3591025,69460,quiescent
/dev/fakeUSB0,471,455,464,453,1843,3396649,69480,quiescent
/dev/fakeUSB0,479,481,477,468,1905,3629025,69500,quiescent
/dev/fakeUSB0,467,468,459,467,1861,3463321,69520,quiescent
/dev/fakeUSB0,470,476,482,470,1898,3602404,69540,quiescent
/dev/fakeUSB0,460,465,465,465,1855,3441025,69560,quiescent
/dev/fakeUSB0,467,471,476,476,1890,3572100,69580,quiescent
/dev/fakeUSB0,462,464,454,466,1846,3407716,69600,quiescent
/dev/fakeUSB0,463,475,476,467,1881,3538161,69620,quiescent
/dev/fakeUSB0,462,468,458,460,1848,3415104,69640,quiescent
/dev/fakeUSB0,472,476,476,462,1886,3556996,69660,quiescent
/dev/fakeUSB0,470,471,470,465,1876,3519376,69680,quiescent
/dev/fakeUSB0,465,472,467,468,1872,3504384,69700,quiescent
/dev/fakeUSB0,462,466,463,472,1863,3470769,69720,quiescent
/dev/fakeUSB0,466,469,476,471,1882,3541924,69740,quiescent
/dev/fakeUSB0,468,473,467,469,1877,3523129,69760,quiescent
/dev/fakeUSB0,473,466,462,473,1874,3511876,69780,quiescent
/dev/fakeUSB0,473,468,472,471,1884,3549456,69800,quiescent
/dev/fakeUSB0,466,466,464,472,1868,3489424,69820,quiescent
/dev/fakeUSB0,475,479,480,466,1900,3610000,69840,quiescent
/dev/fakeUSB0,468,465,462,464,1859,3455881,69860,quiescent
/dev/fakeUSB0,468,475,475,473,1891,3575881,69880,quiescent
/dev/fakeUSB0,461,460,468,468,1857,3448449,69900,quiescent
/dev/fakeUSB0,469,484,479,473,1905,3629025,69920,quiescent
/dev/fakeUSB0,463,464,468,468,1863,3470769,69940,quiescent
/dev/fakeUSB0,474,473,484,475,1906,3632836,69960,quiescent
/dev/fakeUSB0,469,460,463,467,1859,3455881,69980,quiescent
/dev/fakeUSB0,475,475,480,465,1895,3591025,70000,quiescent
/dev/fakeUSB0,465,460,455,465,1845,3404025,70020,quiescent
/dev/fakeUSB0,475,473,468,475,1891,3575881,70040,quiescent
/dev/fakeUSB0,468,464,465,464,1861,3463321,70060,quiescent
/dev/fakeUSB0,468,479,472,467,1886,3556996,70080,quiescent
/dev/fakeUSB0,464,460,460,462,1846,3407716,70100,quiescent
/dev/fakeUSB0,460,473,476,467,1876,3519376,70120,quiescent
/dev/fakeUSB0,464,460,463,468,1855,3441025,70140,quiescent
/dev/fakeUSB0,471,474,477,473,1895,3591025,70160,quiescent
/dev/fakeUSB0,469,471,463,462,1865,3478225,70180,quiescent
/dev/fakeUSB0,467,471,471,472,1881,3538161,70200,quiescent
/dev/fakeUSB0,474,464,477,467,1882,3541924,70220,quiescent
/dev/fakeUSB0,472,468,466,467,1873,3508129,70240,quiescent
/dev/fakeUSB0,476,473,474,469,1892,3579664,70260,quiescent
/dev/fakeUSB0,468,463,469,469,1869,3493161,70280,quiescent
/dev/fakeUSB0,460,477,472,476,1885,3553225,70300,quiescent
/dev/fakeUSB0,457,465,467,470,1859,3455881,70320,quiescent
/dev/fakeUSB0,468,480,481,473,1902,3617604,70340,quiescent
/dev/fakeUSB0,459,463,470,467,1859,3455881,70360,quiescent
/dev/fakeUSB0,468,476,480,472,1896,3594816,70380,quiescent
/dev/fakeUSB0,468,468,472,465,1873,3508129,70400,quiescent
/dev/fakeUSB0,479,488,487,470,1924,3701776,70420,quiescent
/dev/fakeUSB0,475,470,462,464,1871,3500641,70440,quiescent
/dev/fakeUSB0,477,483,478,468,1906,3632836,70460,quiescent
/dev/fakeUSB0,470,463,463,457,1853,3433609,70480,quiescent
/dev/fakeUSB0,468,481,482,465,1896,3594816,70500,quiescent
/dev/fakeUSB0,453,465,467,469,1854,3437316,70520,quiescent
/dev/fakeUSB0,465,481,484,472,1902,3617604,70540,quiescent
/dev/fakeUSB0,461,456,466,468,1851,3426201,70560,quiescent
/dev/fakeUSB0,469,471,475,476,1891,3575881,70580,quiescent
/dev/fakeUSB0,465,458,461,467,1851,3426201,70600,quiescent
/dev/fakeUSB0,471,472,464,466,1873,3508129,70620,quiescent
/dev/fakeUSB0,460,461,460,461,1842,3392964,70640,quiescent
/dev/fakeUSB0,473,481,474,469,1897,3598609,70660,quiescent
/dev/fakeUSB0,467,476,466,468,1877,3523129,70680,quiescent
/dev/fakeUSB0,467,473,474,463,1877,3523129,70700,quiescent
/dev/fakeUSB0,468,476,471,467,1882,3541924,70720,quiescent
/dev/fakeUSB0,463,475,473,473,1884,3549456,70740,quiescent
/dev/fakeUSB0,468,474,468,476,1886,3556996,70760,quiescent
/dev/fakeUSB0,471,467,466,469,1873,3508129,70780,quiescent
/dev/fakeUSB0,470,478,471,468,1887,3560769,70800,quiescent
/dev/fakeUSB0,470,465,465,463,1863,3470769,70820,quiescent
/dev/fakeUSB0,475,478,482,470,1905,3629025,70840,quiescent
/dev/fakeUSB0,469,468,467,467,1871,3500641,70860,quiescent
/dev/fakeUSB0,474,473,480,467,1894,3587236,70880,quiescent
/dev/fakeUSB0,467,459,462,467,1855,3441025,70900,quiescent
/dev/fakeUSB0,476,477,478,470,1901,3613801,70920,quiescent
/dev/fakeUSB0,462,468,460,465,1855,3441025,70940,quiescent
/dev/fakeUSB0,471,483,480,473,1907,3636649,70960,quiescent
/dev/fakeUSB0,460,459,458,461,1838,3378244,70980,quiescent
/dev/fakeUSB0,464,480,481,464,1889,3568321,71000,quiescent
/dev/fakeUSB0,464,462,463,460,1849,3418801,71020,quiescent
/dev/fakeUSB0,465,476,470,465,1876,3519376,71040,quiescent
/dev/fakeUSB0,462,459,452,467,1840,3385600,71060,quiescent
/dev/fakeUSB0,479,474,480,472,1905,3629025,71080,quiescent
/dev/fakeUSB0,468,469,466,471,1874,3511876,71100,quiescent
/dev/fakeUSB0,476,481,484,468,1909,3644281,71120,quiescent
/dev/fakeUSB0,470,466,472,469,1877,3523129,71140,quiescent
/dev/fakeUSB0,469,464,464,466,1863,3470769,71160,quiescent
/dev/fakeUSB0,462,459,462,468,1851,3426201,71180,quiescent
/dev/fakeUSB0,465,466,469,467,1867,3485689,71200,quiescent
/dev/fakeUSB0,466,467,467,476,1876,3519376,71220,quiescent
/dev/fakeUSB0,472,472,466,475,1885,3553225,71240,quiescent
/dev/fakeUSB0,468,471,468,468,1875,3515625,71260,quiescent
/dev/fakeUSB0,467,471,460,469,1867,3485689,71280,quiescent
/dev/fakeUSB0,469,479,481,477,1906,3632836,71300,quiescent
/dev/fakeUSB0,474,471,466,462,1873,3508129,71320,quiescent
/dev/fakeUSB0,471,480,478,468,1897,3598609,71340,quiescent
/dev/fakeUSB0,464,467,476,459,1866,3481956,71360,quiescent
/dev/fakeUSB0,469,471,483,467,1890,3572100,71380,quiescent
/dev/fakeUSB0,469,463,463,464,1859,3455881,71400,quiescent
/dev/fakeUSB0,474,480,474,469,1897,3598609,71420,quiescent
/dev/fakeUSB0,467,457,462,466,1852,3429904,71440,quiescent
/dev/fakeUSB0,474,476,469,471,1890,3572100,71460,quiescent
/dev/fakeUSB0,468,461,459,456,1844,3400336,71480,quiescent
/dev/fakeUSB0,472,476,470,477,1895,3591025,71500,quiescent
/dev/fakeUSB0,471,463,463,468,1865,3478225,71520,quiescent
/dev/fakeUSB0,472,477,484,479,1912,3655744,71540,quiescent
/dev/fakeUSB0,468,466,461,461,1856,3444736,71560,quiescent
/dev/fakeUSB0,470,472,479,469,1890,3572100,71580,quiescent
/dev/fakeUSB0,465,464,466,461,1856,3444736,71600,quiescent
/dev/fakeUSB0,471,478,480,473,1902,3617604,71620,quiescent
/dev/fakeUSB0,460,468,463,471,1862,3467044,71640,quiescent
/dev/fakeUSB0,461,476,471,468,1876,3519376,71660,quiescent
/dev/fakeUSB0,465,475,469,473,1882,3541924,71680,quiescent
/dev/fakeUSB0,467,470,480,468,1885,3553225,71700,quiescent
/dev/fakeUSB0,472,467,478,461,1878,3526884,71720,quiescent
/dev/fakeUSB0,464,467,473,465,1869,3493161,71740,quiescent
/dev/fakeUSB0,471,468,475,467,1881,3538161,71760,quiescent
/dev/fakeUSB0,469,466,462,458,1855,3441025,71780,quiescent
/dev/fakeUSB0,468,477,475,477,1897,3598609,71800,quiescent
/dev/fakeUSB0,469,469,472,466,1876,3519376,71820,quiescent
/dev/fakeUSB0,472,483,476,468,1899,3606201,71840,quiescent
/dev/fakeUSB0,468,467,472,466,1873,3508129,71860,quiescent
/dev/fakeUSB0,473,481,492,477,1923,3697929,71880,quiescent
/dev/fakeUSB0,467,460,461,462,1850,3422500,71900,quiescent
/dev/fakeUSB0,468,469,481,472,1890,3572100,71920,quiescent
/dev/fakeUSB0,468,461,462,461,1852,3429904,71940,quiescent
/dev/fakeUSB0,474,483,479,472,1908,3640464,71960,quiescent
/dev/fakeUSB0,468,468,462,467,1865,3478225,71980,quiescent
/dev/fakeUSB0,472,476,470,472,1890,3572100,72000,quiescent
/dev/fakeUSB0,468,460,456,467,1851,3426201,72020,quiescent
/dev/fakeUSB0,468,479,476,478,1901,3613801,72040,quiescent
/dev/fakeUSB0,472,465,465,460,1862,3467044,72060,quiescent
/dev/fakeUSB0,468,473,479,470,1890,3572100,72080,quiescent
/dev/fakeUSB0,470,460,472,457,1859,3455881,72100,quiescent
/dev/fakeUSB0,470,473,480,471,1894,3587236,72120,quiescent
/dev/fakeUSB0,465,459,472,463,1859,3455881,72140,quiescent
/dev/fakeUSB0,470,472,477,465,1884,3549456,72160,quiescent
/dev/fakeUSB0,465,476,475,472,1888,3564544,72180,quiescent
/dev/fakeUSB0,474,481,475,470,1900,3610000,72200,quiescent
/dev/fakeUSB0,487,476,479,468,1910,3648100,72220,quiescent
/dev/fakeUSB0,476,469,471,461,1877,3523129,72240,quiescent
/dev/fakeUSB0,467,468,470,470,1875,3515625,72260,quiescent
/dev/fakeUSB0,466,462,462,471,1861,3463321,72280,quiescent
/dev/fakeUSB0,464,468,476,471,1879,3530641,72300,quiescent
/dev/fakeUSB0,460,460,466,470,1856,3444736,72320,quiescent
/dev/fakeUSB0,472,479,479,472,1902,3617604,72340,quiescent
/dev/fakeUSB0,464,467,465,468,1864,3474496,72360,quiescent
/dev/fakeUSB0,468,485,483,468,1904,3625216,72380,quiescent
/dev/fakeUSB0,467,465,455,464,1851,3426201,72400,quiescent
/dev/fakeUSB0,469,479,476,467,1891,3575881,72420,quiescent
/dev/fakeUSB0,461,464,465,456,1846,3407716,72440,quiescent
/dev/fakeUSB0,473,483,483,469,1908,3640464,72460,quiescent
/dev/fakeUSB0,472,460,465,460,1857,3448449,72480,quiescent
/dev/fakeUSB0,471,470,484,462,1887,3560769,72500,quiescent
/dev/fakeUSB0,465,460,472,457,1854,3437316,72520,quiescent
/dev/fakeUSB0,467,476,489,475,1907,3636649,72540,quiescent
/dev/fakeUSB0,472,461,473,461,1867,3485689,72560,quiescent
/dev/fakeUSB0,475,476,479,468,1898,3602404,72580,quiescent
/dev/fakeUSB0,475,467,464,469,1875,3515625,72600,quiescent
/dev/fakeUSB0,469,474,470,465,1878,3526884,72620,quiescent
/dev/fakeUSB0,471,471,467,462,1871,3500641,72640,quiescent
/dev/fakeUSB0,470,473,472,464,1879,3530641,72660,quiescent
/dev/fakeUSB0,466,468,464,468,1866,3481956,72680,quiescent
/dev/fakeUSB0,468,468,475,464,1875,3515625,72700,quiescent
/dev/fakeUSB0,465,468,479,469,1881,3538161,72720,quiescent
/dev/fakeUSB0,469,468,470,461,1868,3489424,72740,quiescent
/dev/fakeUSB0,462,460,469,467,1858,3452164,72760,quiescent
/dev/fakeUSB0,465,469,461,476,1871,3500641,72780,quiescent
/dev/fakeUSB0,465,476,475,475,1891,3575881,72800,quiescent
/dev/fakeUSB0,472,474,464,473,1883,3545689,72820,quiescent
/dev/fakeUSB0,468,479,478,475,1900,3610000,72840,quiescent
/dev/fakeUSB0,468,471,460,466,1865,3478225,72860,quiescent
/dev/fakeUSB0,471,473,480,474,1898,3602404,72880,quiescent
/dev/fakeUSB0,468,460,469,470,1867,3485689,72900,quiescent
/dev/fakeUSB0,472,474,483,468,1897,3598609,72920,quiescent
/dev/fakeUSB0,469,464,462,469,1864,3474496,72940,quiescent
/dev/fakeUSB0,471,481,477,471,1900,3610000,72960,quiescent
/dev/fakeUSB0,460,463,472,461,1856,3444736,72980,quiescent
/dev/fakeUSB0,465,479,485,473,1902,3617604,73000,quiescent
/dev/fakeUSB0,463,467,459,459,1848,3415104,73020,quiescent
/dev/fakeUSB0,468,477,483,475,1903,3621409,73040,quiescent
/dev/fakeUSB0,469,470,463,463,1865,3478225,73060,quiescent
/dev/fakeUSB0,473,480,469,468,1890,3572100,73080,quiescent
/dev/fakeUSB0,468,465,464,469,1866,3481956,73100,quiescent
/dev/fakeUSB0,466,476,466,464,1872,3504384,73120,quiescent
/dev/fakeUSB0,466,444,464,464,1838,3378244,73140,quiescent
/dev/fakeUSB0,465,474,472,465,1876,3519376,73160,quiescent
/dev/fakeUSB0,460,472,475,467,1874,3511876,73180,quiescent
/dev/fakeUSB0,464,472,480,467,1883,3545689,73200,quiescent
/dev/fakeUSB0,465,468,471,476,1880,3534400,73220,quiescent
/dev/fakeUSB0,464,468,477,471,1880,3534400,73240,quiescent
/dev/fakeUSB0,467,470,472,468,1877,3523129,73260,quiescent
/dev/fakeUSB0,473,464,470,463,1870,3496900,73280,quiescent
/dev/fakeUSB0,467,482,484,468,1901,3613801,73300,quiescent
/dev/fakeUSB0,465,472,469,462,1868,3489424,73320,quiescent
/dev/fakeUSB0,464,488,472,465,1889,3568321,73340,quiescent
/dev/fakeUSB0,468,473,473,465,1879,3530641,73360,quiescent
/dev/fakeUSB0,470,483,480,469,1902,3617604,73380,quiescent
/dev/fakeUSB0,468,476,468,466,1878,3526884,73400,quiescent
/dev/fakeUSB0,472,482,482,477,1913,3659569,73420,quiescent
/dev/fakeUSB0,465,464,465,467,1861,3463321,73440,quiescent
/dev/fakeUSB0,467,478,479,479,1903,3621409,73460,quiescent
/dev/fakeUSB0,458,456,460,464,1838,3378244,73480,quiescent
/dev/fakeUSB0,467,469,476,466,1878,3526884,73500,quiescent
/dev/fakeUSB0,469,462,459,460,1850,3422500,73520,quiescent
/dev/fakeUSB0,474,480,476,476,1906,3632836,73540,quiescent
/dev/fakeUSB0,473,463,460,468,1864,3474496,73560,quiescent
/dev/fakeUSB0,475,484,488,474,1921,3690241,73580,quiescent
/dev/fakeUSB0,470,468,471,468,1877,3523129,73600,quiescent
/dev/fakeUSB0,469,476,484,469,1898,3602404,73620,quiescent
/dev/fakeUSB0,470,472,476,464,1882,3541924,73640,quiescent
/dev/fakeUSB0,468,478,476,471,1893,3583449,73660,quiescent
/dev/fakeUSB0,463,480,475,469,1887,3560769,73680,quiescent
/dev/fakeUSB0,472,476,479,463,1890,3572100,73700,quiescent
/dev/fakeUSB0,468,471,469,467,1875,3515625,73720,quiescent
/dev/fakeUSB0,467,468,466,467,1868,3489424,73740,quiescent
/dev/fakeUSB0,463,471,476,474,1884,3549456,73760,quiescent
/dev/fakeUSB0,469,460,468,464,1861,3463321,73780,quiescent
/dev/fakeUSB0,468,470,483,467,1888,3564544,73800,quiescent
/dev/fakeUSB0,464,469,468,470,1871,3500641,73820,quiescent
/dev/fakeUSB0,467,480,478,476,1901,3613801,73840,quiescent
/dev/fakeUSB0,466,468,460,464,1858,3452164,73860,quiescent
/dev/fakeUSB0,469,480,483,476,1908,3640464,73880,quiescent
/dev/fakeUSB0,469,462,464,461,1856,3444736,73900,quiescent
/dev/fakeUSB0,476,476,480,472,1904,3625216,73920,quiescent
/dev/fakeUSB0,468,460,466,460,1854,3437316,73940,quiescent
/dev/fakeUSB0,469,475,485,479,1908,3640464,73960,quiescent
/dev/fakeUSB0,468,468,465,461,1862,3467044,73980,quiescent
/dev/fakeUSB0,466,481,488,470,1905,3629025,74000,quiescent
/dev/fakeUSB0,473,461,468,465,1867,3485689,74020,quiescent
/dev/fakeUSB0,476,478,472,469,1895,3591025,74040,quiescent
/dev/fakeUSB0,467,452,465,463,1847,3411409,74060,quiescent
/dev/fakeUSB0,467,472,473,473,1885,3553225,74080,quiescent
/dev/fakeUSB0,462,464,466,467,1859,3455881,74100,quiescent
/dev/fakeUSB0,463,477,475,472,1887,3560769,74120,quiescent
/dev/fakeUSB0,465,470,475,473,1883,3545689,74140,quiescent
/dev/fakeUSB0,462,477,478,474,1891,3575881,74160,quiescent
/dev/fakeUSB0,468,467,463,473,1871,3500641,74180,quiescent
/dev/fakeUSB0,472,471,471,467,1881,3538161,74200,quiescent
/dev/fakeUSB0,461,469,470,461,1861,3463321,74220,quiescent
/dev/fakeUSB0,476,472,472,468,1888,3564544,74240,quiescent
/dev/fakeUSB0,473,479,468,469,1889,3568321,74260,quiescent
/dev/fakeUSB0,478,470,469,467,1884,3549456,74280,quiescent
/dev/fakeUSB0,466,474,469,468,1877,3523129,74300,quiescent
/dev/fakeUSB0,464,459,455,468,1846,3407716,74320,quiescent
/dev/fakeUSB0,467,471,459,468,1865,3478225,74340,quiescent
/dev/fakeUSB0,467,456,462,460,1845,3404025,74360,quiescent
/dev/fakeUSB0,472,476,476,468,1892,3579664,74380,quiescent
/dev/fakeUSB0,469,452,472,465,1858,3452164,74400,quiescent
/dev/fakeUSB0,474,475,481,474,1904,3625216,74420,quiescent
/dev/fakeUSB0,460,464,460,474,1858,3452164,74440,quiescent
/dev/fakeUSB0,470,473,484,467,1894,3587236,74460,quiescent
/dev/fakeUSB0,471,457,465,462,1855,3441025,74480,quiescent
/dev/fakeUSB0,477,481,472,473,1903,3621409,74500,quiescent
/dev/fakeUSB0,464,464,462,465,1855,3441025,74520,quiescent
/dev/fakeUSB0,474,476,481,472,1903,3621409,74540,quiescent
/dev/fakeUSB0,468,456,469,460,1853,3433609,74560,quiescent
/dev/fakeUSB0,467,475,474,464,1880,3534400,74580,quiescent
/dev/fakeUSB0,455,460,467,456,1838,3378244,74600,quiescent
/dev/fakeUSB0,464,465,474,463,1866,3481956,74620,quiescent
/dev/fakeUSB0,460,460,469,467,1856,3444736,74640,quiescent
/dev/fakeUSB0,464,470,472,465,1871,3500641,74660,quiescent
/dev/fakeUSB0,468,463,471,470,1872,3504384,74680,quiescent
/dev/fakeUSB0,476,475,472,467,1890,3572100,74700,quiescent
/dev/fakeUSB0,476,474,470,466,1886,3556996,74720,quiescent
/dev/fakeUSB0,472,475,468,470,1885,3553225,74740,quiescent
/dev/fakeUSB0,468,470,471,475,1884,3549456,74760,quiescent
/dev/fakeUSB0,469,466,466,470,1871,3500641,74780,quiescent
/dev/fakeUSB0,471,467,483,477,1898,3602404,74800,quiescent
/dev/fakeUSB0,468,465,472,469,1874,3511876,74820,quiescent
/dev/fakeUSB0,474,473,478,464,1889,3568321,74840,quiescent
/dev/fakeUSB0,470,456,467,465,1858,3452164,74860,quiescent
/dev/fakeUSB0,462,477,475,466,1880,3534400,74880,quiescent
/dev/fakeUSB0,463,468,460,471,1862,3467044,74900,quiescent
/dev/fakeUSB0,461,481,472,470,1884,3549456,74920,quiescent
/dev/fakeUSB0,469,467,462,470,1868,3489424,74940,quiescent
/dev/fakeUSB0,474,482,475,469,1900,3610000,74960,quiescent
/dev/fakeUSB0,467,464,457,460,1848,3415104,74980,quiescent
/dev/fakeUSB0,480,481,472,463,1896,3594816,75000,quiescent
/dev/fakeUSB0,468,463,461,459,1851,3426201,75020,glitch
/dev/fakeUSB0,471,475,480,476,1902,3617604,75040,glitch
/dev/fakeUSB0,466,457,464,460,1847,3411409,75060,glitch
/dev/fakeUSB0,468,472,480,466,1886,3556996,75080,glitch
/dev/fakeUSB0,468,467,468,466,1869,3493161,75100,glitch
/dev/fakeUSB0,472,471,476,472,1891,3575881,75120,glitch
/dev/fakeUSB0,470,464,462,461,1857,3448449,75140,glitch
/dev/fakeUSB0,476,484,465,472,1897,3598609,75160,glitch
/dev/fakeUSB0,472,475,470,465,1882,3541924,75180,glitch
/dev/fakeUSB0,474,467,476,472,1889,3568321,75200,glitch
/dev/fakeUSB0,475,463,474,475,1887,3560769,75220,glitch
/dev/fakeUSB0,473,470,472,471,1886,3556996,75240,glitch
/dev/fakeUSB0,476,483,484,466,1909,3644281,75260,glitch
/dev/fakeUSB0,485,492,477,464,1918,3678724,75280,glitch
/dev/fakeUSB0,480,504,484,468,1936,3748096,75300,glitch
/dev/fakeUSB0,472,508,464,483,1927,3713329,75320,glitch
/dev/fakeUSB0,471,590,479,468,2008,4032064,75340,glitch
/dev/fakeUSB0,468,887,464,460,2279,5193841,75360,glitch
/dev/fakeUSB0,480,1017,482,475,2454,6022116,75380,glitch
/dev/fakeUSB0,536,1023,467,470,2496,6230016,75400,glitch
/dev/fakeUSB0,1023,1009,485,474,2991,8946081,75420,glitch
/dev/fakeUSB0,1023,1023,453,467,2966,8797156,75440,glitch
/dev/fakeUSB0,1023,1023,480,476,3002,9012004,75460,glitch
/dev/fakeUSB0,1023,1023,458,465,2969,8814961,75480,glitch
/dev/fakeUSB0,1023,1015,475,471,2984,8904256,75500,glitch
/dev/fakeUSB0,1023,1023,460,468,2974,8844676,75520,glitch
/dev/fakeUSB0,1023,757,479,463,2722,7409284,75540,glitch
/dev/fakeUSB0,1023,540,466,459,2488,6190144,75560,glitch
/dev/fakeUSB0,1023,439,476,471,2409,5803281,75580,glitch
/dev/fakeUSB0,1023,380,460,462,2325,5405625,75600,glitch
/dev/fakeUSB0,1023,388,476,470,2357,5555449,75620,glitch
/dev/fakeUSB0,620,397,457,455,1929,3721041,75640,glitch
/dev/fakeUSB0,106,428,471,471,1476,2178576,75660,glitch
/dev/fakeUSB0,0,448,458,468,1374,1887876,75680,glitch
/dev/fakeUSB0,0,470,471,473,1414,1999396,75700,glitch
/dev/fakeUSB0,0,474,468,473,1415,2002225,75720,glitch
/dev/fakeUSB0,168,480,462,460,1570,2464900,75740,glitch
/dev/fakeUSB0,308,480,476,467,1731,2996361,75760,glitch
/dev/fakeUSB0,410,478,466,467,1821,3316041,75780,glitch
/dev/fakeUSB0,440,479,467,464,1850,3422500,75800,glitch
/dev/fakeUSB0,417,468,459,458,1802,3247204,75820,glitch
/dev/fakeUSB0,538,474,477,474,1963,3853369,75840,glitch
/dev/fakeUSB0,807,465,463,465,2200,4840000,75860,glitch
/dev/fakeUSB0,1023,483,479,473,2458,6041764,75880,glitch
/dev/fakeUSB0,1023,464,451,461,2399,5755201,75900,glitch
/dev/fakeUSB0,927,482,475,465,2349,5517801,75920,glitch
/dev/fakeUSB0,692,469,449,468,2078,4318084,75940,glitch
/dev/fakeUSB0,539,478,479,477,1973,3892729,75960,glitch
/dev/fakeUSB0,426,461,467,468,1822,3319684,75980,glitch
/dev/fakeUSB0,372,479,479,466,1796,3225616,76000,glitch
/dev/fakeUSB0,351,467,456,468,1742,3034564,76020,glitch
/dev/fakeUSB0,358,479,472,468,1777,3157729,76040,glitch
/dev/fakeUSB0,365,474,462,463,1764,3111696,76060,glitch
/dev/fakeUSB0,376,485,479,474,1814,3290596,76080,glitch
/dev/fakeUSB0,362,472,462,464,1760,3097600,76100,glitch
/dev/fakeUSB0,382,477,475,475,1809,3272481,76120,glitch
/dev/fakeUSB0,400,473,471,464,1808,3268864,76140,glitch
/dev/fakeUSB0,348,484,472,465,1769,3129361,76160,glitch
/dev/fakeUSB0,225,475,464,466,1630,2656900,76180,glitch
/dev/fakeUSB0,81,478,470,465,1494,2232036,76200,glitch
/dev/fakeUSB0,0,469,470,462,1401,1962801,76220,glitch
/dev/fakeUSB0,0,479,461,462,1402,1965604,76240,glitch
/dev/fakeUSB0,0,479,472,471,1422,2022084,76260,glitch
/dev/fakeUSB0,0,480,469,468,1417,2007889,76280,glitch
/dev/fakeUSB0,0,491,473,466,1430,2044900,76300,glitch
/dev/fakeUSB0,84,472,466,472,1494,2232036,76320,glitch
/dev/fakeUSB0,505,474,468,470,1917,3674889,76340,glitch
/dev/fakeUSB0,807,462,459,472,2200,4840000,76360,glitch
/dev/fakeUSB0,1023,470,468,469,2430,5904900,76380,glitch
/dev/fakeUSB0,1012,446,449,464,2371,5621641,76400,glitch
/dev/fakeUSB0,1015,464,475,465,2419,5851561,76420,glitch
/dev/fakeUSB0,1020,459,455,456,2390,5712100,76440,glitch
/dev/fakeUSB0,248,468,488,483,1687,2845969,76460,glitch
/dev/fakeUSB0,0,459,467,468,1394,1943236,76480,glitch
/dev/fakeUSB0,0,485,484,470,1439,2070721,76500,glitch
/dev/fakeUSB0,1014,481,461,462,2418,5846724,76520,glitch
/dev/fakeUSB0,1023,500,476,471,2470,6100900,76540,glitch
/dev/fakeUSB0,997,476,468,460,2401,5764801,76560,glitch
/dev/fakeUSB0,1023,489,476,472,2460,6051600,76580,glitch
/dev/fakeUSB0,1023,476,457,464,2420,5856400,76600,glitch
/dev/fakeUSB0,1023,489,469,472,2453,6017209,76620,glitch
/dev/fakeUSB0,1023,477,461,468,2429,5900041,76640,glitch
/dev/fakeUSB0,1023,466,466,456,2411,5812921,76660,glitch
/dev/fakeUSB0,1023,467,461,460,2411,5812921,76680,glitch
/dev/fakeUSB0,795,464,474,472,2205,4862025,76700,glitch
/dev/fakeUSB0,611,459,477,473,2020,4080400,76720,glitch
/dev/fakeUSB0,496,465,471,467,1899,3606201,76740,glitch
/dev/fakeUSB0,458,468,481,468,1875,3515625,76760,glitch
/dev/fakeUSB0,444,464,465,467,1840,3385600,76780,glitch
/dev/fakeUSB0,453,475,471,474,1873,3508129,76800,glitch
/dev/fakeUSB0,469,461,462,458,1850,3422500,76820,glitch
/dev/fakeUSB0,479,478,468,465,1890,3572100,76840,glitch
/dev/fakeUSB0,484,454,466,461,1865,3478225,76860,glitch
/dev/fakeUSB0,485,472,472,471,1900,3610000,76880,glitch
/dev/fakeUSB0,484,452,461,468,1865,3478225,76900,glitch
/dev/fakeUSB0,480,482,467,464,1893,3583449,76920,glitch
/dev/fakeUSB0,473,463,465,466,1867,3485689,76940,glitch
/dev/fakeUSB0,480,483,473,464,1900,3610000,76960,glitch
/dev/fakeUSB0,464,470,456,472,1862,3467044,76980,glitch
/dev/fakeUSB0,469,481,479,479,1908,3640464,77000,glitch
/dev/fakeUSB0,455,462,466,462,1845,3404025,77020,glitch
/dev/fakeUSB0,456,474,476,474,1880,3534400,77040,glitch
/dev/fakeUSB0,454,454,460,460,1828,3341584,77060,glitch
/dev/fakeUSB0,458,476,470,467,1871,3500641,77080,glitch
/dev/fakeUSB0,475,467,460,460,1862,3467044,77100,glitch
/dev/fakeUSB0,473,478,476,474,1901,3613801,77120,glitch
/dev/fakeUSB0,489,469,468,461,1887,3560769,77140,glitch
/dev/fakeUSB0,494,473,477,478,1922,3694084,77160,glitch
/dev/fakeUSB0,496,464,472,476,1908,3640464,77180,glitch
/dev/fakeUSB0,506,465,472,476,1919,3682561,77200,glitch
/dev/fakeUSB0,508,470,466,468,1912,3655744,77220,glitch
/dev/fakeUSB0,500,475,456,467,1898,3602404,77240,glitch
/dev/fakeUSB0,506,479,477,465,1927,3713329,77260,glitch
/dev/fakeUSB0,487,452,464,463,1866,3481956,77280,glitch
/dev/fakeUSB0,474,340,468,471,1753,3073009,77300,glitch
/dev/fakeUSB0,468,209,470,472,1619,2621161,77320,glitch
/dev/fakeUSB0,459,170,467,473,1569,2461761,77340,glitch
/dev/fakeUSB0,456,154,459,471,1540,2371600,77360,glitch
/dev/fakeUSB0,459,170,479,464,1572,2471184,77380,glitch
/dev/fakeUSB0,468,125,462,465,1520,2310400,77400,glitch
/dev/fakeUSB0,479,52,476,473,1480,2190400,77420,glitch
